"","CowId","DIM_Target","CaseOrControl","Calving","DIM","ReadCountRaw","ReadCountTrim","Batch","ReadCountHost","FarmId","SampleType","DaysToInfection","WeeksToInfection","ReadCountNonHost","SampleId"
"USDA1","1756","7","Case","4/24/19",-26,32637477,30675098,"1",16032400,"Farm D","Sample",-33,"-5",14642698,"USDA1"
"USDA9","1705","4","Control","4/1/19",-3,34044168,33206628,"1",24848858,"Farm D","Sample",-7,"-1",8357770,"USDA9"
"USDA19","1732","10","Case","4/5/19",-7,30054834,29284564,"1",12754187,"Farm D","Sample",-17,"-3",16530377,"USDA19"
"USDA21","1748","2","Control","4/30/19",-32,30499981,29776566,"3",2243695,"Farm D","Sample",-34,"-5",27532871,"USDA21"
"USDA24","1747","3","Control","4/15/19",3,28473605,27729619,"1",154392,"Farm D","Sample",0,"-1",27575227,"USDA24"
"USDA31","1710","10","Case","4/5/19",-7,28497243,28033482,"1",845287,"Farm D","Sample",-17,"-3",27188195,"USDA31"
"USDA38","1702","6","Case","3/30/19",5,42272106,41075663,"2",38961861,"Farm D","Sample",-1,"-1",2113802,"USDA38"
"USDA43","1715","2","Control","5/14/19",-26,26088655,25571022,"1",2777470,"Farm D","Sample",-28,"-4",22793552,"USDA43"
"USDA44","1716","3","Case","5/7/19",-19,27373043,26768828,"2",2794358,"Farm D","Sample",-22,"-4",23974470,"USDA44"
"USDA47","1714","7","Control","5/9/19",-21,22541919,21782396,"2",7572227,"Farm D","Sample",-28,"-4",14210169,"USDA47"
"USDA48","8438","5","Control","5/5/19",-17,30361215,29739977,"1",1819852,"Farm D","Sample",-22,"-4",27920125,"USDA48"
"USDA52","1760","7","Control","5/23/19",-35,27807752,27076434,"2",3663193,"Farm D","Sample",-42,"-6",23413241,"USDA52"
"USDA54","1735","3","Control","4/28/19",-10,32714968,32053778,"2",1976361,"Farm D","Sample",-13,"-2",30077417,"USDA54"
"USDA55","1725","8","Control","4/24/19",-26,51147486,49881109,"1",6657174,"Farm D","Sample",-34,"-5",43223935,"USDA55"
"USDA56","8441","9","Case","4/6/19",-8,32913724,30076658,"3",4193135,"Farm D","Sample",-17,"-3",25883523,"USDA56"
"USDA58","1754","2","Case","4/30/19",-32,35489935,33801253,"2",14743558,"Farm D","Sample",-34,"-5",19057695,"USDA58"
"USDA60","1737","4","Control","4/14/19",-16,28246880,27661565,"1",2094088,"Farm D","Sample",-20,"-3",25567477,"USDA60"
"USDA61","1725","8","Control","4/24/19",-6,46000054,44597492,"1",1017564,"Farm D","Sample",-14,"-2",43579928,"USDA61"
"USDA64","1748","2","Control","4/30/19",-12,40851409,40031399,"1",2017904,"Farm D","Sample",-14,"-2",38013495,"USDA64"
"USDA66","1751","10","Control","5/6/19",-18,35549871,34643590,"3",8851403,"Farm D","Sample",-28,"-4",25792187,"USDA66"
"USDA67","1754","2","Case","4/30/19",-12,27315632,26639262,"2",2614534,"Farm D","Sample",-14,"-2",24024728,"USDA67"
"USDA68","1750","10","Case","4/22/19",-4,28848809,26508904,"1",555753,"Farm D","Sample",-14,"-2",25953151,"USDA68"
"USDA72","1755","9","Case","4/23/19",-4,33066529,32022717,"2",2060774,"Farm D","Sample",-13,"-2",29961943,"USDA72"
"USDA75","1727","4","Case","4/1/19",3,27806308,27267366,"1",12375491,"Farm D","Sample",-1,"-1",14891875,"USDA75"
"USDA79","1719","1","Case","4/4/19",0,34796240,33869078,"2",28313372,"Farm D","Sample",-1,"-1",5555706,"USDA79"
"USDA80","1705","4","Control","4/1/19",3,33497766,32656240,"3",1415099,"Farm D","Sample",-1,"-1",31241141,"USDA80"
"USDA81","1736","14","Control","3/22/19",13,34852275,33399422,"2",594662,"Farm D","Sample",-1,"-1",32804760,"USDA81"
"USDA83","1742","2","Control","4/3/19",1,28624787,28026067,"1",8303404,"Farm D","Sample",-1,"-1",19722663,"USDA83"
"USDA91","1749","9","Control","4/6/19",-8,31984312,31066571,"1",4290105,"Farm D","Sample",-17,"-3",26776466,"USDA91"
"USDA95","1755","9","Case","4/23/19",-25,23213923,22624372,"1",8266968,"Farm D","Sample",-34,"-5",14357404,"USDA95"
"USDA96","1733","6","Case","4/12/19",-14,32932177,31798233,"2",13844949,"Farm D","Sample",-20,"-3",17953284,"USDA96"
"USDA98","1750","10","Case","4/22/19",-24,31336631,30570840,"2",1024878,"Farm D","Sample",-34,"-5",29545962,"USDA98"
"USDA99","1727","4","Case","4/1/19",-3,24154685,23595588,"1",21753840,"Farm D","Sample",-7,"-1",1841748,"USDA99"
"USDA100","1735","3","Control","4/28/19",-30,36103153,35091474,"2",214363,"Farm D","Sample",-33,"-5",34877111,"USDA100"
"USDA101","1720","4","Case","4/1/19",-3,29543190,28671674,"2",23988163,"Farm D","Sample",-7,"-1",4683511,"USDA101"
"USDA105","1747","3","Control","4/15/19",-17,31262341,30695756,"3",1581590,"Farm D","Sample",-20,"-3",29114166,"USDA105"
"USDA106","1739","9","Case","4/9/19",-11,34761262,33914720,"3",33214345,"Farm D","Sample",-20,"-3",700375,"USDA106"
"USDA108","1756","7","Case","4/24/19",-6,16257090,16019657,"1",212432,"Farm D","Sample",-13,"-2",15807225,"USDA108"
"USDA112","1756","7","Case","4/24/19",7,28053150,27408857,"2",1412310,"Farm D","Sample",0,"-1",25996547,"USDA112"
"USDA114","1735","3","Control","4/28/19",3,28147098,27454145,"3",327891,"Farm D","Sample",0,"-1",27126254,"USDA114"
"USDA122","1739","9","Case","4/9/19",9,30681654,30103686,"1",130437,"Farm D","Sample",0,"-1",29973249,"USDA122"
"USDA126","1733","6","Case","4/12/19",6,29145722,28483089,"2",928259,"Farm D","Sample",0,"-1",27554830,"USDA126"
"USDA130","1737","4","Control","4/14/19",4,28520984,28016320,"1",158585,"Farm D","Sample",0,"-1",27857735,"USDA130"
"USDA158","84697","4","Case","8/5/19",-6,25764357,25024977,"1",16077656,"Farm A","Sample",-10,"-2",8947321,"USDA158"
"USDA160","84446","7","Case","8/16/19",-17,22302751,21886826,"1",701681,"Farm A","Sample",-24,"-4",21185145,"USDA160"
"USDA168","93514","25","Case","8/1/19",-2,30733700,29924902,"1",3615791,"Farm A","Sample",-27,"-4",26309111,"USDA168"
"USDA173","83657","8","Case","8/1/19",-2,22158269,21539500,"2",14283281,"Farm A","Sample",-10,"-2",7256219,"USDA173"
"USDA180","35786","2","Control","8/3/19",-4,24843293,24043031,"2",4945286,"Farm A","Sample",-6,"-1",19097745,"USDA180"
"USDA183","84133","7","Control","8/2/19",-3,37552030,36200433,"2",67060,"Farm A","Sample",-10,"-2",36133373,"USDA183"
"USDA186","5814","7","Control","8/2/19",-3,30873529,29688870,"1",6782265,"Farm A","Sample",-10,"-2",22906605,"USDA186"
"USDA262","68481","4","Case","8/11/19",-12,34346152,33132396,"2",2941154,"Farm A","Sample",-16,"-3",30191242,"USDA262"
"USDA291","84771","5","Control","8/10/19",-11,30794811,29947123,"2",3073970,"Farm A","Sample",-16,"-3",26873153,"USDA291"
"USDA294","84521","4","Case","8/26/19",-27,31557003,30847362,"1",631077,"Farm A","Sample",-31,"-5",30216285,"USDA294"
"USDA297","5798","6","Case","8/9/19",-10,39180649,37978260,"3",31814474,"Farm A","Sample",-16,"-3",6163786,"USDA297"
"USDA311","84753","7","Control","8/30/19",-31,25053136,23716911,"2",1690756,"Farm A","Sample",-38,"-6",22026155,"USDA311"
"USDA329","1713","13","Case","3/16/19",5,33973451,30793109,"1",21927253,"Farm D","Sample",-8,"-2",8865856,"USDA329"
"USDA330","1740","2","Case","3/19/19",2,29903615,29084426,"1",453251,"Farm D","Sample",0,"-1",28631175,"USDA330"
"USDA332","1716","3","Case","5/7/19",-25,35349215,34621794,"1",659148,"Farm D","Sample",-28,"-4",33962646,"USDA332"
"USDA333","1756","7","Case","4/24/19",-12,30050702,29399544,"3",5445673,"Farm D","Sample",-19,"-3",23953871,"USDA333"
"USDA335","1725","8","Control","4/24/19",-12,27893309,27310155,"1",2092793,"Farm D","Sample",-20,"-3",25217362,"USDA335"
"USDA339","1754","2","Case","4/30/19",-18,36802315,36035932,"2",3003608,"Farm D","Sample",-20,"-3",33032324,"USDA339"
"USDA340","8438","5","Control","5/5/19",-23,34160297,33348518,"2",534513,"Farm D","Sample",-28,"-4",32814005,"USDA340"
"USDA343","1706","2","Case","3/19/19",2,29033584,28246768,"3",13283080,"Farm D","Sample",0,"-1",14963688,"USDA343"
"USDA350","1708","0","Case","3/15/19",-14,27187494,26470349,"2",20934618,"Farm D","Sample",-14,"-2",5535731,"USDA350"
"USDA353","8444","6","Control","3/23/19",-22,29487527,28692652,"2",6093153,"Farm D","Sample",-28,"-4",22599499,"USDA353"
"USDA356","1735","3","Control","4/28/19",-16,29261984,28554101,"3",1313527,"Farm D","Sample",-19,"-3",27240574,"USDA356"
"USDA357","1748","2","Control","4/30/19",-18,91827,69967,"3",3848,"Farm D","Sample",-20,"-3",66119,"USDA357"
"USDA359","1755","9","Case","4/23/19",-11,28053298,27388625,"3",703318,"Farm D","Sample",-20,"-3",26685307,"USDA359"
"USDA362","8440","8","Control","3/28/19",-3,32472007,31791351,"3",2657505,"Farm D","Sample",-11,"-2",29133846,"USDA362"
"USDA363","1724","1","Case","3/28/19",-3,26087711,25495945,"2",10144532,"Farm D","Sample",-4,"-1",15351413,"USDA363"
"USDA366","1730","2","Case","4/3/19",-9,28154297,26826950,"2",20274612,"Farm D","Sample",-11,"-2",6552338,"USDA366"
"USDA368","1701","6","Control","4/9/19",6,30857701,29988267,"1",535979,"Farm D","Sample",0,"-1",29452288,"USDA368"
"USDA374","1710","10","Case","4/5/19",10,35775986,35095290,"3",65972,"Farm D","Sample",0,"-1",35029318,"USDA374"
"USDA377","1749","9","Control","4/6/19",9,37613855,36104507,"2",407592,"Farm D","Sample",0,"-1",35696915,"USDA377"
"USDA379","1725","8","Control","4/24/19",-34,24424768,23644651,"2",912169,"Farm D","Sample",-42,"-6",22732482,"USDA379"
"USDA385","1727","4","Case","4/1/19",-31,28441495,27701290,"3",12596986,"Farm D","Sample",-35,"-5",15104304,"USDA385"
"USDA388","1705","4","Control","4/1/19",-31,27401073,26692694,"2",9443231,"Farm D","Sample",-35,"-5",17249463,"USDA388"
"USDA391","1736","14","Control","3/22/19",-21,40315673,38553483,"2",25351302,"Farm D","Sample",-35,"-5",13202181,"USDA391"
"USDA393","1732","10","Case","4/5/19",-35,36434482,35490451,"1",24475523,"Farm D","Sample",-45,"â‰¥ -7",11014928,"USDA393"
"USDA396","1704","2","Case","3/13/19",-26,38222768,37320505,"1",33908793,"Farm D","Sample",-28,"-4",3411712,"USDA396"
"USDA403","1732","10","Case","4/5/19",10,23559480,22808821,"2",3186225,"Farm D","Sample",0,"-1",19622596,"USDA403"
"USDA406","8441","9","Case","4/6/19",9,32780604,31896016,"3",171015,"Farm D","Sample",0,"-1",31725001,"USDA406"
"USDA415","1747","3","Control","4/15/19",0,30556781,29822335,"2",2308138,"Farm D","Sample",-3,"-1",27514197,"USDA415"
"USDA416","1725","8","Control","4/24/19",-9,25458790,24761686,"2",13237975,"Farm D","Sample",-17,"-3",11523711,"USDA416"
"USDA420","1751","10","Control","5/6/19",-21,30218407,29673988,"1",6115923,"Farm D","Sample",-31,"-5",23558065,"USDA420"
"USDA424","1733","6","Case","4/12/19",3,31961687,30329347,"2",9530129,"Farm D","Sample",-3,"-1",20799218,"USDA424"
"USDA425","1748","2","Control","4/30/19",-15,30411225,29744495,"1",10909521,"Farm D","Sample",-17,"-3",18834974,"USDA425"
"USDA426","1715","2","Control","5/14/19",-29,30298956,29136639,"2",13686548,"Farm D","Sample",-31,"-5",15450091,"USDA426"
"USDA431","1716","3","Case","5/7/19",-22,26264528,25734284,"1",2936524,"Farm D","Sample",-25,"-4",22797760,"USDA431"
"USDA434","1730","2","Case","4/3/19",-33,35107287,34283543,"2",2375535,"Farm D","Sample",-35,"-5",31908008,"USDA434"
"USDA435","1710","10","Case","4/5/19",-35,31155894,29025104,"1",5171350,"Farm D","Sample",-45,"â‰¥ -7",23853754,"USDA435"
"USDA436","1706","2","Case","3/19/19",-18,32318990,31481316,"2",16505767,"Farm D","Sample",-20,"-3",14975549,"USDA436"
"USDA437","8433","8","Control","3/28/19",-27,29305416,28636747,"2",1256725,"Farm D","Sample",-35,"-5",27380022,"USDA437"
"USDA440","1719","1","Case","4/4/19",-34,31788308,30922977,"2",29241561,"Farm D","Sample",-35,"-5",1681416,"USDA440"
"USDA443","1702","6","Case","3/30/19",-29,27799887,27060694,"2",26736648,"Farm D","Sample",-35,"-5",324046,"USDA443"
"USDA444","1724","1","Case","3/28/19",-27,30330213,29521450,"2",11305031,"Farm D","Sample",-28,"-4",18216419,"USDA444"
"USDA447","1708","0","Case","3/15/19",-28,41384383,35777555,"2",24070717,"Farm D","Sample",-28,"-4",11706838,"USDA447"
"USDA452","1706","2","Case","3/19/19",-32,26899906,26148958,"2",17856827,"Farm D","Sample",-34,"-5",8292131,"USDA452"
"USDA454","1740","2","Case","3/19/19",-32,31541990,30684798,"3",3827318,"Farm D","Sample",-34,"-5",26857480,"USDA454"
"USDA457","1750","10","Case","4/22/19",-17,27884230,27080956,"3",3696118,"Farm D","Sample",-27,"-4",23384838,"USDA457"
"USDA458","1714","7","Control","5/9/19",-34,34741147,33910606,"3",6917760,"Farm D","Sample",-41,"-6",26992846,"USDA458"
"USDA459","1737","4","Control","4/14/19",-9,35268104,34111488,"1",1103363,"Farm D","Sample",-13,"-2",33008125,"USDA459"
"USDA460","1735","3","Control","4/28/19",-23,37830322,36577311,"2",2910250,"Farm D","Sample",-26,"-4",33667061,"USDA460"
"USDA462","1749","9","Control","4/6/19",-1,33258973,32521774,"3",1342590,"Farm D","Sample",-10,"-2",31179184,"USDA462"
"USDA463","1754","2","Case","4/30/19",-25,33485971,32609246,"2",31795352,"Farm D","Sample",-27,"-4",813894,"USDA463"
"USDA465","8441","9","Case","4/6/19",-1,33881347,33125820,"3",12040856,"Farm D","Sample",-10,"-2",21084964,"USDA465"
"USDA466","1701","6","Control","4/9/19",-4,27896780,26970933,"2",1297779,"Farm D","Sample",-10,"-2",25673154,"USDA466"
"USDA467","8429","5","Control","4/10/19",-5,30646554,29947015,"1",138412,"Farm D","Sample",-10,"-2",29808603,"USDA467"
"USDA470","8440","8","Control","3/28/19",-13,29221418,28427843,"2",7434143,"Farm D","Sample",-21,"-3",20993700,"USDA470"
"USDA471","1737","4","Control","4/14/19",-30,26080579,24761601,"2",2520677,"Farm D","Sample",-34,"-5",22240924,"USDA471"
"USDA472","8441","9","Case","4/6/19",-22,26031939,25377896,"2",1608310,"Farm D","Sample",-31,"-5",23769586,"USDA472"
"USDA475","1727","4","Case","4/1/19",-17,36453209,34443609,"1",16254667,"Farm D","Sample",-21,"-3",18188942,"USDA475"
"USDA476","1702","6","Case","3/30/19",-15,32746024,32064437,"1",16961639,"Farm D","Sample",-21,"-3",15102798,"USDA476"
"USDA477","1736","14","Control","3/22/19",-7,35087734,34429376,"1",6025997,"Farm D","Sample",-21,"-3",28403379,"USDA477"
"USDA478","1730","2","Case","4/3/19",-19,39176353,38334554,"3",27083434,"Farm D","Sample",-21,"-3",11251120,"USDA478"
"USDA479","8429","5","Control","4/10/19",-26,36644028,35796480,"3",1435801,"Farm D","Sample",-31,"-5",34360679,"USDA479"
"USDA481","8429","5","Control","4/10/19",-12,26763662,26175567,"2",2577982,"Farm D","Sample",-17,"-3",23597585,"USDA481"
"USDA483","1730","2","Case","4/3/19",-5,35983964,34534276,"2",19709568,"Farm D","Sample",-7,"-1",14824708,"USDA483"
"USDA485","1702","6","Case","3/30/19",-1,37404466,36583670,"3",32736050,"Farm D","Sample",-7,"-1",3847620,"USDA485"
"USDA487","1719","1","Case","4/4/19",-6,35515553,34772916,"1",10899595,"Farm D","Sample",-7,"-1",23873321,"USDA487"
"USDA488","1742","2","Control","4/3/19",-5,28759165,28171022,"1",2943154,"Farm D","Sample",-7,"-1",25227868,"USDA488"
"USDA489","1705","4","Control","4/1/19",-17,28600102,27973751,"3",16932868,"Farm D","Sample",-21,"-3",11040883,"USDA489"
"USDA490","1701","6","Control","4/9/19",-25,28202160,27636546,"1",3307930,"Farm D","Sample",-31,"-5",24328616,"USDA490"
"USDA491","1710","10","Case","4/5/19",-21,33705851,33036271,"1",1884602,"Farm D","Sample",-31,"-5",31151669,"USDA491"
"USDA492","1747","3","Control","4/15/19",-31,29189655,28423671,"1",4035309,"Farm D","Sample",-34,"-5",24388362,"USDA492"
"USDA494","1732","10","Case","4/5/19",-21,34014103,32999018,"2",31177917,"Farm D","Sample",-31,"-5",1821101,"USDA494"
"USDA505","23792","5","Control","6/12/19",-13,41573203,39505960,"2",515268,"Farm B","Sample",-18,"-3",38990692,"USDA505"
"USDA507","23577","4","Case","5/30/19",0,33422893,32638818,"1",30580911,"Farm B","Sample",-4,"-1",2057907,"USDA507"
"USDA510","23883","0","Control","6/10/19",-11,26746309,25348712,"2",8187400,"Farm B","Sample",-11,"-2",17161312,"USDA510"
"USDA511","24012","2","Control","6/11/19",-12,30121765,29467920,"3",3677420,"Farm B","Sample",-14,"-2",25790500,"USDA511"
"USDA514","22961","2","Case","6/4/19",-5,32881400,32025336,"2",25886981,"Farm B","Sample",-7,"-1",6138355,"USDA514"
"USDA516","23917","1","Case","6/2/19",-3,27091975,26526683,"1",11782304,"Farm B","Sample",-4,"-1",14744379,"USDA516"
"USDA519","23915","25","Case","5/9/19",25,35701856,34957499,"2",1346610,"Farm B","Sample",0,"-1",33610889,"USDA519"
"USDA526","23872","11","Case","5/23/19",11,30413218,29791582,"1",8439428,"Farm B","Sample",0,"-1",21352154,"USDA526"
"USDA528","23760","18","Case","5/23/19",11,30255532,29451839,"2",20758743,"Farm B","Sample",-7,"-1",8693096,"USDA528"
"USDA533","23740","0","Case","4/29/19",-25,28533940,27715715,"1",5302631,"Farm B","Sample",-25,"-4",22413084,"USDA533"
"USDA534","23701","2","Control","4/30/19",-26,27979512,27335168,"2",1628784,"Farm B","Sample",-28,"-4",25706384,"USDA534"
"USDA539","23805","3","Case","4/26/19",-22,31538877,30576253,"2",233079,"Farm B","Sample",-25,"-4",30343174,"USDA539"
"USDA542","1703","0","Control","3/29/19",-14,34771071,34119108,"1",615237,"Farm D","Sample",-14,"-2",33503871,"USDA542"
"USDA544","1719","1","Case","4/4/19",-20,39311449,37738016,"1",7770396,"Farm D","Sample",-21,"-3",29967620,"USDA544"
"USDA545","1720","4","Case","4/1/19",-17,31628908,30827824,"2",8360556,"Farm D","Sample",-21,"-3",22467268,"USDA545"
"USDA550","1713","13","Case","3/16/19",-29,32352668,31325680,"2",25661695,"Farm D","Sample",-42,"-6",5663985,"USDA550"
"USDA558","1720","4","Case","4/1/19",-31,34116848,33433763,"1",4232106,"Farm D","Sample",-35,"-5",29201657,"USDA558"
"USDA561","1703","0","Control","3/29/19",-28,30429869,29760767,"1",9938934,"Farm D","Sample",-28,"-4",19821833,"USDA561"
"USDA569","8444","6","Control","3/23/19",5,36099098,35275020,"3",9753201,"Farm D","Sample",-1,"-1",25521819,"USDA569"
"USDA570","1703","0","Control","3/29/19",-1,29402686,28620904,"1",27557001,"Farm D","Sample",-1,"-1",1063903,"USDA570"
"USDA574","8444","6","Control","3/23/19",-8,22391842,21673485,"2",3652576,"Farm D","Sample",-14,"-2",18020909,"USDA574"
"USDA576","1733","6","Case","4/12/19",-28,33568087,32742564,"2",32480270,"Farm D","Sample",-34,"-5",262294,"USDA576"
"USDA577","23819","10","Control","5/31/19",-1,26547447,26065880,"1",697391,"Farm B","Sample",-11,"-2",25368489,"USDA577"
"USDA579","23642","3","Control","5/31/19",-1,34724318,33731846,"2",5731661,"Farm B","Sample",-4,"-1",28000185,"USDA579"
"USDA583","24236","2","Control","6/4/19",-5,25548417,24999726,"1",422776,"Farm B","Sample",-7,"-1",24576950,"USDA583"
"USDA584","23100","11","Control","5/30/19",0,30985500,30024759,"3",790174,"Farm B","Sample",-11,"-2",29234585,"USDA584"
"USDA585","23357","0","Case","6/3/19",-4,25974046,25378753,"2",841415,"Farm B","Sample",-4,"-1",24537338,"USDA585"
"USDA594","1754","2","Case","4/30/19",2,35772273,34847147,"2",6161007,"Farm D","Sample",0,"-1",28686140,"USDA594"
"USDA596","1725","8","Control","4/24/19",8,24089004,23091438,"2",1270899,"Farm D","Sample",0,"-1",21820539,"USDA596"
"USDA603","1750","10","Case","4/22/19",10,23171506,22610673,"1",956182,"Farm D","Sample",0,"-1",21654491,"USDA603"
"USDA605","1755","9","Case","4/23/19",9,32481060,31349281,"1",7307706,"Farm D","Sample",0,"-1",24041575,"USDA605"
"USDA613","8438","5","Control","5/5/19",-30,29543628,28850641,"3",5085111,"Farm D","Sample",-35,"-5",23765530,"USDA613"
"USDA614","1755","9","Case","4/23/19",-18,35516795,34651276,"3",12385758,"Farm D","Sample",-27,"-4",22265518,"USDA614"
"USDA615","1756","7","Case","4/24/19",-19,29299718,28645457,"1",19066658,"Farm D","Sample",-26,"-4",9578799,"USDA615"
"USDA617","1739","9","Case","4/9/19",-4,26959752,26246654,"2",20221521,"Farm D","Sample",-13,"-2",6025133,"USDA617"
"USDA620","1751","10","Control","5/6/19",-24,40410709,39259186,"3",34169479,"Farm D","Sample",-34,"-5",5089707,"USDA620"
"USDA621","1733","6","Case","4/12/19",0,38213005,37290019,"3",32118110,"Farm D","Sample",-6,"-1",5171909,"USDA621"
"USDA622","1714","7","Control","5/9/19",-27,26370311,25765469,"2",5811816,"Farm D","Sample",-34,"-5",19953653,"USDA622"
"USDA623","1750","10","Case","4/22/19",-10,24405972,23876000,"1",8040460,"Farm D","Sample",-20,"-3",15835540,"USDA623"
"USDA626","1756","7","Case","4/24/19",-34,27011101,26346799,"1",4701131,"Farm D","Sample",-41,"-6",21645668,"USDA626"
"USDA628","1727","4","Case","4/1/19",-11,30850990,30173122,"1",21960160,"Farm D","Sample",-15,"-3",8212962,"USDA628"
"USDA630","1701","6","Control","4/9/19",-19,33433666,32770521,"1",3782207,"Farm D","Sample",-25,"-4",28988314,"USDA630"
"USDA631","1747","3","Control","4/15/19",-25,24476981,23898393,"2",5546288,"Farm D","Sample",-28,"-4",18352105,"USDA631"
"USDA633","1713","13","Case","3/16/19",-1,30613545,29117250,"2",26335763,"Farm D","Sample",-14,"-2",2781487,"USDA633"
"USDA634","1733","6","Case","4/12/19",-22,39352706,36911680,"1",26401713,"Farm D","Sample",-28,"-4",10509967,"USDA634"
"USDA637","1750","10","Case","4/22/19",-32,24722763,24173464,"1",3978476,"Farm D","Sample",-42,"-6",20194988,"USDA637"
"USDA639","1755","9","Case","4/23/19",-33,30623721,29946424,"1",20023239,"Farm D","Sample",-42,"-6",9923185,"USDA639"
"USDA640","1703","0","Control","3/29/19",-8,39055466,37724242,"2",2055664,"Farm D","Sample",-8,"-2",35668578,"USDA640"
"USDA642","1749","9","Control","4/6/19",-16,40468282,39299781,"2",17671710,"Farm D","Sample",-25,"-4",21628071,"USDA642"
"USDA643","1702","6","Case","3/30/19",-5,39392111,38486892,"3",25495590,"Farm D","Sample",-11,"-2",12991302,"USDA643"
"USDA645","8429","5","Control","4/10/19",-16,33060233,32349891,"3",331381,"Farm D","Sample",-21,"-3",32018510,"USDA645"
"USDA647","8433","8","Control","3/28/19",-3,18987833,18637641,"1",3767946,"Farm D","Sample",-11,"-2",14869695,"USDA647"
"USDA651","8433","8","Control","3/28/19",-13,53289694,51296760,"1",25894158,"Farm D","Sample",-21,"-3",25402602,"USDA651"
"USDA652","1742","2","Control","4/3/19",-9,29127666,28442037,"3",1377133,"Farm D","Sample",-11,"-2",27064904,"USDA652"
"USDA653","1706","2","Case","3/19/19",-4,42890899,41345271,"3",4231762,"Farm D","Sample",-6,"-1",37113509,"USDA653"
"USDA657","1740","2","Case","3/19/19",-4,31954087,31059809,"2",18989576,"Farm D","Sample",-6,"-1",12070233,"USDA657"
"USDA659","1719","1","Case","4/4/19",-10,28771082,27662940,"1",11778131,"Farm D","Sample",-11,"-2",15884809,"USDA659"
"USDA660","1710","10","Case","4/5/19",-15,27167612,26536658,"1",292321,"Farm D","Sample",-25,"-4",26244337,"USDA660"
"USDA667","23349","4","Case","4/25/19",-28,27730827,27179887,"1",26900092,"Farm B","Sample",-32,"-5",279795,"USDA667"
"USDA672","23801","13","Control","4/23/19",-26,35471133,34657160,"2",7085027,"Farm B","Sample",-39,"-6",27572133,"USDA672"
"USDA682","23419","4","Case","4/25/19",-28,32614911,31438897,"2",6894440,"Farm B","Sample",-32,"-5",24544457,"USDA682"
"USDA684","23909","32","Case","6/1/19",-2,35105723,34370650,"3",33922511,"Farm B","Sample",-34,"-5",448139,"USDA684"
"USDA695","23645","1","Control","4/18/19",-21,23426536,23036020,"3",2156998,"Farm B","Sample",-22,"-4",20879022,"USDA695"
"USDA719","23747","2","Control","4/8/19",-11,30586086,29885146,"2",6447681,"Farm B","Sample",-13,"-2",23437465,"USDA719"
"USDA720","23660","3","Case","4/22/19",-25,29636237,28990254,"1",11554833,"Farm B","Sample",-28,"-4",17435421,"USDA720"
"USDA721","1720","4","Case","4/1/19",-11,29115718,28362971,"1",18039721,"Farm D","Sample",-15,"-3",10323250,"USDA721"
"USDA722","1705","4","Control","4/1/19",-11,27040957,26370731,"1",3394976,"Farm D","Sample",-15,"-3",22975755,"USDA722"
"USDA724","1732","10","Case","4/5/19",-15,33149084,32456541,"1",27352127,"Farm D","Sample",-25,"-4",5104414,"USDA724"
"USDA726","1737","4","Control","4/14/19",-24,52016036,47429513,"1",7898779,"Farm D","Sample",-28,"-4",39530734,"USDA726"
"USDA734","1739","9","Case","4/9/19",-19,23706572,22837406,"2",1724635,"Farm D","Sample",-28,"-4",21112771,"USDA734"
"USDA736","8441","9","Case","4/6/19",-16,28637804,27842087,"1",471684,"Farm D","Sample",-25,"-4",27370403,"USDA736"
"USDA757","5573","1","Control","9/26/19",-35,30025506,28974881,"2",203065,"Farm C","Sample",-36,"-6",28771816,"USDA757"
"USDA776","24012","2","Control","6/11/19",2,24262977,23591487,"1",3628648,"Farm B","Sample",0,"-1",19962839,"USDA776"
"USDA782","1715","2","Control","5/14/19",-32,31656521,30998738,"1",13222792,"Farm D","Sample",-34,"-5",17775946,"USDA782"
"USDA791","23801","13","Control","4/23/19",13,37231505,34718971,"1",16844426,"Farm B","Sample",0,"-1",17874545,"USDA791"
"USDA795","23760","18","Case","5/23/19",-28,23971122,23494061,"1",126653,"Farm B","Sample",-46,"â‰¥ -7",23367408,"USDA795"
"USDA797","23456","1","Case","5/22/19",-27,27433652,26878964,"1",9751491,"Farm B","Sample",-28,"-4",17127473,"USDA797"
"USDA798","23877","7","Case","5/20/19",-25,40384532,39373582,"1",10376135,"Farm B","Sample",-32,"-5",28997447,"USDA798"
"USDA820","23025","1","Control","4/3/19",-27,39706621,38827475,"1",10958287,"Farm B","Sample",-28,"-4",27869188,"USDA820"
"USDA822","23760","18","Case","5/23/19",-7,34522508,33844259,"1",10036112,"Farm B","Sample",-25,"-4",23808147,"USDA822"
"USDA825","24049","0","Case","5/27/19",-11,27061192,26447399,"2",4682074,"Farm B","Sample",-11,"-2",21765325,"USDA825"
"USDA866","23792","5","Control","6/12/19",-27,30221430,29211108,"3",809279,"Farm B","Sample",-32,"-5",28401829,"USDA866"
"USDA869","24236","2","Control","6/4/19",-19,25101290,24555184,"1",859746,"Farm B","Sample",-21,"-3",23695438,"USDA869"
"USDA870","23812","2","Control","5/28/19",-12,25566533,24729842,"2",1049487,"Farm B","Sample",-14,"-2",23680355,"USDA870"
"USDA871","23979","1","Control","5/29/19",-13,32400302,31543825,"3",1489226,"Farm B","Sample",-14,"-2",30054599,"USDA871"
"USDA872","23577","4","Case","5/30/19",-14,29294257,28674586,"1",5796316,"Farm B","Sample",-18,"-3",22878270,"USDA872"
"USDA875","23819","10","Control","5/31/19",-15,39163844,37805497,"1",27922555,"Farm B","Sample",-25,"-4",9882942,"USDA875"
"USDA876","23872","11","Case","5/23/19",-7,33819656,33107441,"1",1799959,"Farm B","Sample",-18,"-3",31307482,"USDA876"
"USDA877","23784","3","Control","5/17/19",-1,29959793,29304398,"3",1751695,"Farm B","Sample",-4,"-1",27552703,"USDA877"
"USDA881","23877","7","Case","5/20/19",-4,24391810,23222905,"2",6974011,"Farm B","Sample",-11,"-2",16248894,"USDA881"
"USDA883","23808","3","Case","5/24/19",-8,40190261,39267581,"3",27759153,"Farm B","Sample",-11,"-2",11508428,"USDA883"
"USDA884","23456","1","Case","5/22/19",-6,32996931,31831951,"1",6310758,"Farm B","Sample",-7,"-1",25521193,"USDA884"
"USDA887","23744","4","Control","5/23/19",-7,28568139,27969614,"3",4489684,"Farm B","Sample",-11,"-2",23479930,"USDA887"
"USDA888","23111","2","Case","5/25/19",-9,29857000,29204908,"2",1323154,"Farm B","Sample",-11,"-2",27881754,"USDA888"
"USDA889","23768","0","Case","5/27/19",-11,40112929,39246479,"1",32309135,"Farm B","Sample",-11,"-2",6937344,"USDA889"
"USDA891","23909","32","Case","6/1/19",-16,38103600,37348527,"3",35833761,"Farm B","Sample",-48,"â‰¥ -7",1514766,"USDA891"
"USDA892","23268","4","Case","5/16/19",0,29560356,28860673,"2",16649972,"Farm B","Sample",-4,"-1",12210701,"USDA892"
"USDA896","23792","5","Control","6/12/19",1,33674471,32740895,"2",25279974,"Farm B","Sample",-4,"-1",7460921,"USDA896"
"USDA897","23586","1","Case","5/29/19",-13,25077620,24441099,"1",8476400,"Farm B","Sample",-14,"-2",15964699,"USDA897"
"USDA898","23357","0","Case","6/3/19",-18,27769571,27067337,"3",550888,"Farm B","Sample",-18,"-3",26516449,"USDA898"
"USDA899","23062","3","Control","5/24/19",-8,34903609,33360230,"1",8681179,"Farm B","Sample",-11,"-2",24679051,"USDA899"
"USDA908","23784","3","Control","5/17/19",3,29093196,28498295,"1",7974853,"Farm B","Sample",0,"-1",20523442,"USDA908"
"USDA911","23268","4","Case","5/16/19",4,27975230,26386492,"2",7101255,"Farm B","Sample",0,"-1",19285237,"USDA911"
"USDA927","23660","3","Case","4/22/19",3,32409249,31347067,"1",12738767,"Farm B","Sample",0,"-1",18608300,"USDA927"
"USDA928","23724","16","Case","4/9/19",16,30453668,29843187,"1",2031505,"Farm B","Sample",0,"-1",27811682,"USDA928"
"USDA929","23807","2","Control","4/23/19",2,34282345,33038003,"2",4492643,"Farm B","Sample",0,"-1",28545360,"USDA929"
"USDA949","23349","4","Case","4/25/19",0,27175850,26489630,"2",14252689,"Farm B","Sample",-4,"-1",12236941,"USDA949"
"USDA959","23751","5","Control","5/15/19",5,33533140,32652485,"2",30374002,"Farm B","Sample",0,"-1",2278483,"USDA959"
"USDA967","23349","4","Case","4/25/19",-14,39481896,38402619,"2",37734016,"Farm B","Sample",-18,"-3",668603,"USDA967"
"USDA971","23801","13","Control","4/23/19",-12,42555072,39797184,"2",368731,"Farm B","Sample",-25,"-4",39428453,"USDA971"
"USDA972","23645","1","Control","4/18/19",-7,29022669,28022428,"2",360355,"Farm B","Sample",-8,"-2",27662073,"USDA972"
"USDA977","5386","1","Case","10/10/19",-35,34592884,33466377,"3",4650142,"Farm C","Sample",-36,"-6",28816235,"USDA977"
"USDA989","5527","7","Case","10/4/19",-29,39449906,37927666,"1",24794065,"Farm C","Sample",-36,"-6",13133601,"USDA989"
"USDA993","23419","4","Case","4/25/19",-14,40925707,39689793,"1",6164041,"Farm B","Sample",-18,"-3",33525752,"USDA993"
"USDA996","23660","3","Case","4/22/19",-11,28885488,28308812,"1",2846217,"Farm B","Sample",-14,"-2",25462595,"USDA996"
"USDA1000","23962","1","Case","5/12/19",-31,34031922,33311582,"1",15068295,"Farm B","Sample",-32,"-5",18243287,"USDA1000"
"USDA1001","23614","4","Control","5/5/19",-24,34477504,33782042,"1",7886037,"Farm B","Sample",-28,"-4",25896005,"USDA1001"
"USDA1004","23748","25","Control","5/9/19",-28,31952444,30881166,"1",364819,"Farm B","Sample",-53,"â‰¥ -7",30516347,"USDA1004"
"USDA1007","23667","2","Control","5/4/19",-23,36565406,35872775,"1",1601708,"Farm B","Sample",-25,"-4",34271067,"USDA1007"
"USDA1008","23025","1","Control","4/3/19",1,39045484,37954413,"3",21789829,"Farm B","Sample",0,"-1",16164584,"USDA1008"
"USDA1015","5505","1","Case","9/26/19",-21,26382063,25654649,"1",15111850,"Farm C","Sample",-22,"-4",10542799,"USDA1015"
"USDA1016","5431","13","Case","9/21/19",-16,36293577,35526100,"3",1187052,"Farm C","Sample",-29,"-5",34339048,"USDA1016"
"USDA1018","5573","1","Control","9/26/19",-21,28706715,27970816,"3",131434,"Farm C","Sample",-22,"-4",27839382,"USDA1018"
"USDA1023","1715","2","Control","5/14/19",2,30100781,29589528,"3",31165,"Farm D","Sample",0,"-1",29558363,"USDA1023"
"USDA1033","23909","32","Case","6/1/19",32,28714937,27993647,"2",20316999,"Farm B","Sample",0,"-1",7676648,"USDA1033"
"USDA1041","23787","4","Case","4/19/19",-15,33143223,31523608,"1",1915200,"Farm B","Sample",-19,"-3",29608408,"USDA1041"
"USDA1044","23043","6","Control","4/23/19",-19,30006928,29311131,"2",2576777,"Farm B","Sample",-25,"-4",26734354,"USDA1044"
"USDA1058","23349","4","Case","4/25/19",4,29655626,28777886,"3",4154703,"Farm B","Sample",0,"-1",24623183,"USDA1058"
"USDA1064","23799","0","Case","5/6/19",-25,37054898,36023730,"2",457862,"Farm B","Sample",-25,"-4",35565868,"USDA1064"
"USDA1068","23043","6","Control","4/23/19",6,32908996,31940010,"1",15607901,"Farm B","Sample",0,"-1",16332109,"USDA1068"
"USDA1069","23801","13","Control","4/23/19",6,29481914,28794503,"2",8395590,"Farm B","Sample",-7,"-1",20398913,"USDA1069"
"USDA1072","23277","29","Control","4/28/19",1,30247785,29052999,"2",28163713,"Farm B","Sample",-28,"-4",889286,"USDA1072"
"USDA1073","23419","4","Case","4/25/19",4,26991604,26219853,"2",23862521,"Farm B","Sample",0,"-1",2357332,"USDA1073"
"USDA1074","23915","25","Case","5/9/19",-28,32255677,31543744,"2",683350,"Farm B","Sample",-53,"â‰¥ -7",30860394,"USDA1074"
"USDA1076","23144","3","Control","4/26/19",3,33643673,32803237,"2",15705673,"Farm B","Sample",0,"-1",17097564,"USDA1076"
"USDA1084","23805","3","Case","4/26/19",3,38804540,37774173,"1",11218018,"Farm B","Sample",0,"-1",26556155,"USDA1084"
"USDA1085","23831","18","Control","5/9/19",-28,30279510,29268151,"1",14123487,"Farm B","Sample",-46,"â‰¥ -7",15144664,"USDA1085"
"USDA1090","23445","8","Control","5/5/19",-24,25148587,24500334,"2",1885677,"Farm B","Sample",-32,"-5",22614657,"USDA1090"
"USDA1108","5431","13","Case","9/21/19",-23,47198672,45748477,"1",2572450,"Farm C","Sample",-36,"-6",43176027,"USDA1108"
"USDA1114","5505","1","Case","9/26/19",-28,36887033,36063252,"2",3545846,"Farm C","Sample",-29,"-5",32517406,"USDA1114"
"USDA1122","23620","1","Case","5/15/19",1,18139346,17736021,"3",5561183,"Farm B","Sample",0,"-1",12174838,"USDA1122"
"USDA1149","1751","10","Control","5/6/19",10,44008866,42408880,"2",30436,"Farm D","Sample",0,"-1",42378444,"USDA1149"
"USDA1153","23819","10","Control","5/31/19",10,40969422,40018541,"3",31898282,"Farm B","Sample",0,"-1",8120259,"USDA1153"
"USDA1168","23760","18","Case","5/23/19",18,31328019,30469533,"3",3470662,"Farm B","Sample",0,"-1",26998871,"USDA1168"
"USDA1206","23754","5","Case","4/13/19",-9,30916255,29751588,"2",394257,"Farm B","Sample",-14,"-2",29357331,"USDA1206"
"USDA1207","23730","6","Control","4/13/19",-9,30441053,28582535,"1",1512082,"Farm B","Sample",-15,"-3",27070453,"USDA1207"
"USDA1209","23277","29","Control","4/28/19",-24,30466135,29917755,"1",1010956,"Farm B","Sample",-53,"â‰¥ -7",28906799,"USDA1209"
"USDA1210","23345","4","Case","4/15/19",-11,36817553,36005061,"3",24612128,"Farm B","Sample",-15,"-3",11392933,"USDA1210"
"USDA1211","23724","16","Case","4/9/19",-5,26215842,25598655,"2",7283735,"Farm B","Sample",-21,"-3",18314920,"USDA1211"
"USDA1214","23358","1","Control","5/29/19",1,29538842,28918137,"1",10391201,"Farm B","Sample",0,"-1",18526936,"USDA1214"
"USDA1216","24096","1","Control","5/29/19",1,28020327,27319446,"2",10794564,"Farm B","Sample",0,"-1",16524882,"USDA1216"
"USDA1217","23586","1","Case","5/29/19",1,31514736,30501407,"3",11419579,"Farm B","Sample",0,"-1",19081828,"USDA1217"
"USDA1237","23812","2","Control","5/28/19",2,32914801,31817751,"1",15119779,"Farm B","Sample",0,"-1",16697972,"USDA1237"
"USDA1241","23979","1","Control","5/29/19",1,32127606,31447491,"2",2403351,"Farm B","Sample",0,"-1",29044140,"USDA1241"
"USDA1251","23801","13","Control","4/23/19",0,31993309,30953166,"1",11621373,"Farm B","Sample",-13,"-2",19331793,"USDA1251"
"USDA1253","23787","4","Case","4/19/19",4,30160453,29288372,"2",25672828,"Farm B","Sample",0,"-1",3615544,"USDA1253"
"USDA1269","23980","1","Case","6/9/19",-31,24697797,24137610,"2",550693,"Farm B","Sample",-32,"-5",23586917,"USDA1269"
"USDA1270","23100","11","Control","5/30/19",-21,27155877,26570049,"2",1924150,"Farm B","Sample",-32,"-5",24645899,"USDA1270"
"USDA1271","23917","1","Case","6/2/19",-24,34603199,33725161,"1",32807586,"Farm B","Sample",-25,"-4",917575,"USDA1271"
"USDA1275","22961","2","Case","6/4/19",2,37990241,37113589,"3",29914623,"Farm B","Sample",0,"-1",7198966,"USDA1275"
"USDA1303","23277","29","Control","4/28/19",29,32294542,31046151,"1",3082034,"Farm B","Sample",0,"-1",27964117,"USDA1303"
"USDA1305","23744","4","Control","5/23/19",4,30897408,30178796,"1",16424912,"Farm B","Sample",0,"-1",13753884,"USDA1305"
"USDA1307","23872","11","Case","5/23/19",4,32931940,32069068,"3",10720176,"Farm B","Sample",-7,"-1",21348892,"USDA1307"
"USDA1308","23062","3","Control","5/24/19",3,33030630,32285043,"1",31891072,"Farm B","Sample",0,"-1",393971,"USDA1308"
"USDA1309","23111","2","Case","5/25/19",2,29702872,28484214,"2",27881039,"Farm B","Sample",0,"-1",603175,"USDA1309"
"USDA1310","23768","0","Case","5/27/19",0,40812841,39644340,"1",17958032,"Farm B","Sample",0,"-1",21686308,"USDA1310"
"USDA1314","23877","7","Case","5/20/19",7,38438754,35553551,"1",34568026,"Farm B","Sample",0,"-1",985525,"USDA1314"
"USDA1318","24049","0","Case","5/27/19",0,44978576,43241657,"1",42667641,"Farm B","Sample",0,"-1",574016,"USDA1318"
"USDA1323","23748","25","Control","5/9/19",18,26559573,25976219,"1",18925443,"Farm B","Sample",-7,"-1",7050776,"USDA1323"
"USDA1329","23915","25","Case","5/9/19",18,24430944,23800968,"3",235550,"Farm B","Sample",-7,"-1",23565418,"USDA1329"
"USDA1334","23831","18","Control","5/9/19",18,44402728,43209559,"1",33080994,"Farm B","Sample",0,"-1",10128565,"USDA1334"
"USDA1348","23808","3","Case","5/24/19",3,48169357,46528726,"1",45246054,"Farm B","Sample",0,"-1",1282672,"USDA1348"
"USDA1352","23760","18","Case","5/23/19",4,29550836,28903360,"1",15390379,"Farm B","Sample",-14,"-2",13512981,"USDA1352"
"USDA1361","5460","3","Control","10/8/19",-19,50915694,48433055,"2",4744875,"Farm C","Sample",-22,"-4",43688180,"USDA1361"
"USDA1366","5573","1","Control","9/26/19",-7,34863671,33274111,"2",326404,"Farm C","Sample",-8,"-2",32947707,"USDA1366"
"USDA1374","5505","1","Case","9/26/19",-7,28131964,26953930,"1",5639306,"Farm C","Sample",-8,"-2",21314624,"USDA1374"
"USDA1379","5527","7","Case","10/4/19",-15,37354962,36448166,"3",785167,"Farm C","Sample",-22,"-4",35662999,"USDA1379"
"USDA1381","5386","1","Case","10/10/19",-21,31987362,31090411,"2",12962406,"Farm C","Sample",-22,"-4",18128005,"USDA1381"
"USDA1401","23819","10","Control","5/31/19",3,23144358,22484856,"1",1341750,"Farm B","Sample",-7,"-1",21143106,"USDA1401"
"USDA1403","24236","2","Control","6/4/19",2,30004363,29075081,"2",6530447,"Farm B","Sample",0,"-1",22544634,"USDA1403"
"USDA1406","23740","0","Case","4/29/19",0,33960332,32841212,"2",25272652,"Farm B","Sample",0,"-1",7568560,"USDA1406"
"USDA1414","5431","13","Case","9/21/19",-2,41551657,39332644,"2",3054761,"Farm C","Sample",-15,"-3",36277883,"USDA1414"
"USDA1435","24096","1","Control","5/29/19",-20,32565216,31819887,"3",6364504,"Farm B","Sample",-21,"-3",25455383,"USDA1435"
"USDA1437","22961","2","Case","6/4/19",-26,24870236,24173690,"2",892168,"Farm B","Sample",-28,"-4",23281522,"USDA1437"
"USDA1438","23358","1","Control","5/29/19",-20,28400707,27875943,"1",278349,"Farm B","Sample",-21,"-3",27597594,"USDA1438"
"USDA1439","23883","0","Control","6/10/19",-32,25172835,24703758,"1",118372,"Farm B","Sample",-32,"-5",24585386,"USDA1439"
"USDA1446","23807","2","Control","4/23/19",-12,24713667,23875678,"2",380729,"Farm B","Sample",-14,"-2",23494949,"USDA1446"
"USDA1448","24012","2","Control","6/11/19",-33,40031127,38774506,"1",28390965,"Farm B","Sample",-35,"-5",10383541,"USDA1448"
"USDA1451","23642","3","Control","5/31/19",-22,28750692,27759100,"2",5881857,"Farm B","Sample",-25,"-4",21877243,"USDA1451"
"USDA1452","23831","18","Control","5/9/19",0,32832817,32127085,"3",15014036,"Farm B","Sample",-18,"-3",17113049,"USDA1452"
"USDA1464","23724","16","Case","4/9/19",-33,36563944,35144219,"2",7843179,"Farm B","Sample",-49,"â‰¥ -7",27301040,"USDA1464"
"USDA1470","1706","2","Case","3/19/19",-11,27943722,27263657,"1",6581346,"Farm D","Sample",-13,"-2",20682311,"USDA1470"
"USDA1471","8429","5","Control","4/10/19",-33,35025240,34243750,"3",5919506,"Farm D","Sample",-38,"-6",28324244,"USDA1471"
"USDA1472","1732","10","Case","4/5/19",-28,24995544,24407810,"2",7114912,"Farm D","Sample",-38,"-6",17292898,"USDA1472"
"USDA1474","1730","2","Case","4/3/19",-26,36105140,35334950,"1",20878248,"Farm D","Sample",-28,"-4",14456702,"USDA1474"
"USDA1476","1742","2","Control","4/3/19",-33,36804358,35675727,"1",30978004,"Farm D","Sample",-35,"-5",4697723,"USDA1476"
"USDA1481","1714","7","Control","5/9/19",7,25227075,24793710,"1",43902,"Farm D","Sample",0,"-1",24749808,"USDA1481"
"USDA1496","23909","32","Case","6/1/19",18,25873919,25406492,"1",414248,"Farm B","Sample",-14,"-2",24992244,"USDA1496"
"USDA1501","23962","1","Case","5/12/19",-17,35359651,34592693,"2",7960140,"Farm B","Sample",-18,"-3",26632553,"USDA1501"
"USDA1502","23614","4","Control","5/5/19",-10,30698711,30125108,"1",703471,"Farm B","Sample",-14,"-2",29421637,"USDA1502"
"USDA1503","23667","2","Control","5/4/19",-9,35067457,33454313,"2",16170020,"Farm B","Sample",-11,"-2",17284293,"USDA1503"
"USDA1504","23831","18","Control","5/9/19",-14,23580845,22844426,"1",9000930,"Farm B","Sample",-32,"-5",13843496,"USDA1504"
"USDA1508","23979","1","Control","5/29/19",-34,25596768,24097119,"2",1169894,"Farm B","Sample",-35,"-5",22927225,"USDA1508"
"USDA1510","23062","3","Control","5/24/19",-29,31089613,30467732,"2",645948,"Farm B","Sample",-32,"-5",29821784,"USDA1510"
"USDA1511","23620","1","Case","5/15/19",-20,32072614,31429466,"2",4122115,"Farm B","Sample",-21,"-3",27307351,"USDA1511"
"USDA1513","24157","6","Case","5/7/19",-12,27104384,26409243,"1",11215554,"Farm B","Sample",-18,"-3",15193689,"USDA1513"
"USDA1514","23577","4","Case","5/30/19",-35,34330436,33324510,"3",22349928,"Farm B","Sample",-39,"-6",10974582,"USDA1514"
"USDA1515","23915","25","Case","5/9/19",-14,29143265,28556818,"3",102956,"Farm B","Sample",-39,"-6",28453862,"USDA1515"
"USDA1516","23358","1","Control","5/29/19",-34,20896813,20086075,"2",142159,"Farm B","Sample",-35,"-5",19943916,"USDA1516"
"USDA1518","23768","0","Case","5/27/19",-32,46140126,44141822,"2",1648981,"Farm B","Sample",-32,"-5",42492841,"USDA1518"
"USDA1521","23748","25","Control","5/9/19",-14,35426483,34651199,"3",30720587,"Farm B","Sample",-39,"-6",3930612,"USDA1521"
"USDA1522","23268","4","Case","5/16/19",-21,26720981,26058443,"1",246160,"Farm B","Sample",-25,"-4",25812283,"USDA1522"
"USDA1525","24096","1","Control","5/29/19",-34,28843655,28223969,"1",1689246,"Farm B","Sample",-35,"-5",26534723,"USDA1525"
"USDA1531","23100","11","Control","5/30/19",-35,49176181,47927943,"1",150000,"Farm B","Sample",-46,"â‰¥ -7",47777943,"USDA1531"
"USDA1535","24049","0","Case","5/27/19",-32,37737269,36028150,"2",5149833,"Farm B","Sample",-32,"-5",30878317,"USDA1535"
"USDA1550","23795","1","Control","5/5/19",-10,33862222,32969815,"3",10684434,"Farm B","Sample",-11,"-2",22285381,"USDA1550"
"USDA1551","23799","0","Case","5/6/19",-11,28379585,27742661,"1",791532,"Farm B","Sample",-11,"-2",26951129,"USDA1551"
"USDA1556","23277","29","Control","4/28/19",-3,36037658,35342871,"3",5229084,"Farm B","Sample",-32,"-5",30113787,"USDA1556"
"USDA1557","23805","3","Case","4/26/19",-1,38887969,37590148,"1",3173609,"Farm B","Sample",-4,"-1",34416539,"USDA1557"
"USDA1562","23740","0","Case","4/29/19",-4,31466712,30757815,"1",25802806,"Farm B","Sample",-4,"-1",4955009,"USDA1562"
"USDA1563","23445","8","Control","5/5/19",-10,37668281,36886881,"1",36043708,"Farm B","Sample",-18,"-3",843173,"USDA1563"
"USDA1565","23419","4","Case","4/25/19",0,24971151,24271418,"1",15460841,"Farm B","Sample",-4,"-1",8810577,"USDA1565"
"USDA1567","23701","2","Control","4/30/19",-5,27391315,26711217,"2",2426045,"Farm B","Sample",-7,"-1",24285172,"USDA1567"
"USDA1572","23747","2","Control","4/8/19",2,50040070,48017939,"2",12767691,"Farm B","Sample",0,"-1",35250248,"USDA1572"
"USDA1574","8440","8","Control","3/28/19",-20,34798331,33813478,"3",7844848,"Farm D","Sample",-28,"-4",25968630,"USDA1574"
"USDA1576","1702","6","Case","3/30/19",-22,29788898,28813852,"2",22142960,"Farm D","Sample",-28,"-4",6670892,"USDA1576"
"USDA1577","1733","6","Case","4/12/19",-35,20807700,19686744,"1",8250622,"Farm D","Sample",-41,"-6",11436122,"USDA1577"
"USDA1580","1727","4","Case","4/1/19",-24,38464614,37022045,"1",27604933,"Farm D","Sample",-28,"-4",9417112,"USDA1580"
"USDA1583","1736","14","Control","3/22/19",-14,31297986,30308241,"2",26745619,"Farm D","Sample",-28,"-4",3562622,"USDA1583"
"USDA1585","1742","2","Control","4/3/19",-26,37085735,36197116,"1",34858045,"Farm D","Sample",-28,"-4",1339071,"USDA1585"
"USDA1586","1749","9","Control","4/6/19",-29,26162158,25327576,"1",1809069,"Farm D","Sample",-38,"-6",23518507,"USDA1586"
"USDA1591","1701","6","Control","4/9/19",-32,35556214,34679776,"2",16353579,"Farm D","Sample",-38,"-6",18326197,"USDA1591"
"USDA1594","1708","0","Case","3/15/19",-7,30746922,29888614,"2",17566717,"Farm D","Sample",-7,"-1",12321897,"USDA1594"
"USDA1595","8444","6","Control","3/23/19",-15,32019181,31160498,"2",28873032,"Farm D","Sample",-21,"-3",2287466,"USDA1595"
"USDA1598","1705","4","Control","4/1/19",-24,36945004,35918245,"3",24172410,"Farm D","Sample",-28,"-4",11745835,"USDA1598"
"USDA1599","1719","1","Case","4/4/19",-27,24554579,23850968,"2",18492121,"Farm D","Sample",-28,"-4",5358847,"USDA1599"
"USDA1600","1704","2","Case","3/13/19",-5,31148347,30246649,"2",16191810,"Farm D","Sample",-7,"-1",14054839,"USDA1600"
"USDA1603","1739","9","Case","4/9/19",-32,32725060,31575456,"2",18533795,"Farm D","Sample",-41,"-6",13041661,"USDA1603"
"USDA1608","8441","9","Case","4/6/19",-29,36193326,34846613,"2",3141045,"Farm D","Sample",-38,"-6",31705568,"USDA1608"
"USDA1609","23744","4","Control","5/23/19",0,30695579,29985256,"2",5348914,"Farm B","Sample",-4,"-1",24636342,"USDA1609"
"USDA1613","23357","0","Case","6/3/19",-11,27670212,27072799,"2",3979272,"Farm B","Sample",-11,"-2",23093527,"USDA1613"
"USDA1614","23792","5","Control","6/12/19",-20,35749158,34934873,"2",403397,"Farm B","Sample",-25,"-4",34531476,"USDA1614"
"USDA1621","23577","4","Case","5/30/19",-7,47927115,46697659,"1",21707250,"Farm B","Sample",-11,"-2",24990409,"USDA1621"
"USDA1623","23808","3","Case","5/24/19",-1,41082076,38212882,"1",29710384,"Farm B","Sample",-4,"-1",8502498,"USDA1623"
"USDA1625","24236","2","Control","6/4/19",-12,30164685,29638939,"1",535392,"Farm B","Sample",-14,"-2",29103547,"USDA1625"
"USDA1626","23979","1","Control","5/29/19",-6,29057567,28464192,"1",13508118,"Farm B","Sample",-7,"-1",14956074,"USDA1626"
"USDA1627","23747","2","Control","4/8/19",-25,29236709,28329588,"2",2112390,"Farm B","Sample",-27,"-4",26217198,"USDA1627"
"USDA1633","23872","11","Case","5/23/19",0,28702558,28114779,"2",7162647,"Farm B","Sample",-11,"-2",20952132,"USDA1633"
"USDA1635","23812","2","Control","5/28/19",-5,27497445,26911248,"2",119013,"Farm B","Sample",-7,"-1",26792235,"USDA1635"
"USDA1637","23111","2","Case","5/25/19",-2,27836190,27040234,"3",7950401,"Farm B","Sample",-4,"-1",19089833,"USDA1637"
"USDA1644","23909","32","Case","6/1/19",25,27203300,26169643,"2",12602312,"Farm B","Sample",-7,"-1",13567331,"USDA1644"
"USDA1645","8440","8","Control","3/28/19",-27,29538659,28782421,"2",3560926,"Farm D","Sample",-35,"-5",25221495,"USDA1645"
"USDA1646","1713","13","Case","3/16/19",-15,34296185,33515591,"1",31240024,"Farm D","Sample",-28,"-4",2275567,"USDA1646"
"USDA1648","1704","2","Case","3/13/19",-12,33489388,31062002,"2",19114406,"Farm D","Sample",-14,"-2",11947596,"USDA1648"
"USDA1652","8440","8","Control","3/28/19",-34,23208089,22393937,"2",186013,"Farm D","Sample",-42,"-6",22207924,"USDA1652"
"USDA1659","8433","8","Control","3/28/19",1,21367505,20856256,"2",353880,"Farm D","Sample",-7,"-1",20502376,"USDA1659"
"USDA1663","1713","13","Case","3/16/19",13,27553683,26077351,"2",2330345,"Farm D","Sample",0,"-1",23747006,"USDA1663"
"USDA1664","1736","14","Control","3/22/19",7,29314301,28409680,"2",10667110,"Farm D","Sample",-7,"-1",17742570,"USDA1664"
"USDA1666","8440","8","Control","3/28/19",1,22786197,22179677,"3",414244,"Farm D","Sample",-7,"-1",21765433,"USDA1666"
"USDA1669","1749","9","Control","4/6/19",-22,31155267,30510764,"1",6717507,"Farm D","Sample",-31,"-5",23793257,"USDA1669"
"USDA1670","1705","4","Control","4/1/19",-17,38417828,37553846,"3",1675482,"Farm D","Sample",-21,"-3",35878364,"USDA1670"
"USDA1674","1732","10","Case","4/5/19",-21,27360193,26816710,"1",9919493,"Farm D","Sample",-31,"-5",16897217,"USDA1674"
"USDA1676","1702","6","Case","3/30/19",-15,29986818,29403395,"1",3236139,"Farm D","Sample",-21,"-3",26167256,"USDA1676"
"USDA1679","1703","0","Control","3/29/19",-14,27371322,26904898,"1",314245,"Farm D","Sample",-14,"-2",26590653,"USDA1679"
"USDA1681","1739","9","Case","4/9/19",-25,26639106,25555726,"2",18639690,"Farm D","Sample",-34,"-5",6916036,"USDA1681"
"USDA1682","1736","14","Control","3/22/19",-7,45053067,43398942,"1",116851,"Farm D","Sample",-21,"-3",43282091,"USDA1682"
"USDA1683","1701","6","Control","4/9/19",-25,38219233,35811107,"2",373900,"Farm D","Sample",-31,"-5",35437207,"USDA1683"
"USDA1684","1742","2","Control","4/3/19",-19,35435530,34665684,"2",2743587,"Farm D","Sample",-21,"-3",31922097,"USDA1684"
"USDA1685","1724","1","Case","3/28/19",-13,34033988,31564525,"2",15247582,"Farm D","Sample",-14,"-2",16316943,"USDA1685"
"USDA1687","1703","0","Control","3/29/19",-21,25525462,23989525,"1",7886051,"Farm D","Sample",-21,"-3",16103474,"USDA1687"
"USDA1689","1720","4","Case","4/1/19",-24,36033667,34928863,"2",11864299,"Farm D","Sample",-28,"-4",23064564,"USDA1689"
"USDA1691","8433","8","Control","3/28/19",-35,21130065,20682494,"2",142926,"Farm D","Sample",-43,"â‰¥ -7",20539568,"USDA1691"
"USDA1693","23645","1","Control","4/18/19",-35,31298436,30685210,"1",123818,"Farm B","Sample",-36,"-6",30561392,"USDA1693"
"USDA1698","23883","0","Control","6/10/19",-18,32544091,31423283,"2",13785210,"Farm B","Sample",-18,"-3",17638073,"USDA1698"
"USDA1699","23586","1","Case","5/29/19",-6,24318683,23599755,"2",2002230,"Farm B","Sample",-7,"-1",21597525,"USDA1699"
"USDA1700","24049","0","Case","5/27/19",-4,23772167,23221116,"1",9677141,"Farm B","Sample",-4,"-1",13543975,"USDA1700"
"USDA1701","23917","1","Case","6/2/19",-10,37005630,36212209,"3",3624107,"Farm B","Sample",-11,"-2",32588102,"USDA1701"
"USDA1702","23100","11","Control","5/30/19",-7,35694822,34806556,"1",2423884,"Farm B","Sample",-18,"-3",32382672,"USDA1702"
"USDA1709","24012","2","Control","6/11/19",-19,43380991,41787750,"1",3372152,"Farm B","Sample",-21,"-3",38415598,"USDA1709"
"USDA1714","23744","4","Control","5/23/19",-21,31824621,31042877,"2",712456,"Farm B","Sample",-25,"-4",30330421,"USDA1714"
"USDA1724","23667","2","Control","5/4/19",2,28848560,27501724,"2",10236328,"Farm B","Sample",0,"-1",17265396,"USDA1724"
"USDA1725","23614","4","Control","5/5/19",1,33838672,32964416,"2",30447803,"Farm B","Sample",-3,"-1",2516613,"USDA1725"
"USDA1728","23799","0","Case","5/6/19",0,27929242,27132795,"1",24740756,"Farm B","Sample",0,"-1",2392039,"USDA1728"
"USDA1729","8431","5","Control","5/25/19",-24,34349143,32959322,"2",6052052,"Farm D","Sample",-29,"-5",26907270,"USDA1729"
"USDA1730","1716","3","Case","5/7/19",-6,34569913,33647377,"2",28287934,"Farm D","Sample",-9,"-2",5359443,"USDA1730"
"USDA1731","8438","5","Control","5/5/19",-4,25844393,25022512,"2",128867,"Farm D","Sample",-9,"-2",24893645,"USDA1731"
"USDA1732","1751","10","Control","5/6/19",-5,30536597,29413297,"1",11150565,"Farm D","Sample",-15,"-3",18262732,"USDA1732"
"USDA1736","1714","7","Control","5/9/19",-8,38051458,36378763,"2",34677638,"Farm D","Sample",-15,"-3",1701125,"USDA1736"
"USDA1740","1760","7","Control","5/23/19",-22,24244285,23660525,"3",290898,"Farm D","Sample",-29,"-5",23369627,"USDA1740"
"USDA1743","23795","1","Control","5/5/19",1,36862971,36017136,"3",17243240,"Farm B","Sample",0,"-1",18773896,"USDA1743"
"USDA1744","23784","3","Control","5/17/19",-15,27940491,27345352,"1",1055723,"Farm B","Sample",-18,"-3",26289629,"USDA1744"
"USDA1748","23751","5","Control","5/15/19",-13,30715743,29891336,"2",28930681,"Farm B","Sample",-18,"-3",960655,"USDA1748"
"USDA1751","23445","8","Control","5/5/19",1,30355153,29633474,"3",24224274,"Farm B","Sample",-7,"-1",5409200,"USDA1751"
"USDA1753","1720","4","Case","4/1/19",3,21205785,20711508,"2",262574,"Farm D","Sample",-1,"-1",20448934,"USDA1753"
"USDA1754","8433","8","Control","3/28/19",7,18831284,18310456,"3",771695,"Farm D","Sample",-1,"-1",17538761,"USDA1754"
"USDA1755","1713","13","Case","3/16/19",-8,37778575,36029763,"2",35386706,"Farm D","Sample",-21,"-3",643057,"USDA1755"
"USDA1757","1730","2","Case","4/3/19",1,36449466,35683798,"3",28855383,"Farm D","Sample",-1,"-1",6828415,"USDA1757"
"USDA1758","1737","4","Control","4/14/19",-30,38037591,36967003,"1",2011418,"Farm D","Sample",-34,"-5",34955585,"USDA1758"
"USDA1759","1708","0","Case","3/15/19",0,34558518,33497139,"2",32033570,"Farm D","Sample",0,"-1",1463569,"USDA1759"
"USDA1761","1710","10","Case","4/5/19",-28,30895575,30252527,"1",2933766,"Farm D","Sample",-38,"-6",27318761,"USDA1761"
"USDA1762","1724","1","Case","3/28/19",-20,29859998,28039805,"1",7563634,"Farm D","Sample",-21,"-3",20476171,"USDA1762"
"USDA1763","8440","8","Control","3/28/19",7,24144373,23664229,"1",91951,"Farm D","Sample",-1,"-1",23572278,"USDA1763"
"USDA1771","23614","4","Control","5/5/19",-3,28831841,27919947,"1",1451353,"Farm B","Sample",-7,"-1",26468594,"USDA1771"
"USDA1772","24157","6","Case","5/7/19",-5,35650617,34882083,"3",17619435,"Farm B","Sample",-11,"-2",17262648,"USDA1772"
"USDA1776","23831","18","Control","5/9/19",-7,29658052,28884057,"2",27973783,"Farm B","Sample",-25,"-4",910274,"USDA1776"
"USDA1786","23795","1","Control","5/5/19",-3,28640747,28041411,"1",9725094,"Farm B","Sample",-4,"-1",18316317,"USDA1786"
"USDA1788","23915","25","Case","5/9/19",-7,37434211,36382853,"3",222532,"Farm B","Sample",-32,"-5",36160321,"USDA1788"
"USDA1789","23667","2","Control","5/4/19",-2,31736122,30924589,"3",9314329,"Farm B","Sample",-4,"-1",21610260,"USDA1789"
"USDA1790","23748","25","Control","5/9/19",-7,35543139,34688707,"3",32233969,"Farm B","Sample",-32,"-5",2454738,"USDA1790"
"USDA1793","23962","1","Case","5/12/19",-10,39525380,38585342,"1",26986959,"Farm B","Sample",-11,"-2",11598383,"USDA1793"
"USDA1795","23445","8","Control","5/5/19",-3,30593623,29746086,"2",19939938,"Farm B","Sample",-11,"-2",9806148,"USDA1795"
"USDA1799","23799","0","Case","5/6/19",-4,23152131,22665867,"1",1282190,"Farm B","Sample",-4,"-1",21383677,"USDA1799"
"USDA1804","23909","32","Case","6/1/19",-9,32794473,31922439,"2",28638315,"Farm B","Sample",-41,"-6",3284124,"USDA1804"
"USDA1807","23268","4","Case","5/16/19",-35,32698196,31926134,"1",1150949,"Farm B","Sample",-39,"-6",30775185,"USDA1807"
"USDA1814","23620","1","Case","5/15/19",-34,33841770,32774570,"1",916784,"Farm B","Sample",-35,"-5",31857786,"USDA1814"
"USDA1822","23962","1","Case","5/12/19",1,30827872,29701088,"2",23376407,"Farm B","Sample",0,"-1",6324681,"USDA1822"
"USDA1827","23792","5","Control","6/12/19",-30,25197864,24366807,"2",844714,"Farm B","Sample",-35,"-5",23522093,"USDA1827"
"USDA1834","23445","8","Control","5/5/19",8,34914613,33976792,"3",11225881,"Farm B","Sample",0,"-1",22750911,"USDA1834"
"USDA1840","93845","5","Case","9/18/19",-21,29047785,28232599,"1",14370359,"Farm A","Sample",-26,"-4",13862240,"USDA1840"
"USDA1846","87216","15","Case","10/3/19",-23,49402449,48525165,"1",10598463,"Farm A","Sample",-38,"-6",37926702,"USDA1846"
"USDA1848","84924","7","Case","9/28/19",-18,24084497,23623569,"1",337865,"Farm A","Sample",-25,"-4",23285704,"USDA1848"
"USDA1856","5845","25","Control","7/25/19",25,29978309,29331761,"1",8540615,"Farm A","Sample",0,"-1",20791146,"USDA1856"
"USDA1861","68923","7","Control","10/5/19",-25,26724011,26202774,"2",177867,"Farm A","Sample",-32,"-5",26024907,"USDA1861"
"USDA1864","94122","23","Control","10/14/19",-34,23952682,23372336,"1",3769696,"Farm A","Sample",-57,"â‰¥ -7",19602640,"USDA1864"
"USDA1866","84901","11","Control","9/28/19",-18,15995675,15620638,"1",165699,"Farm A","Sample",-29,"-5",15454939,"USDA1866"
"USDA1890","94134","22","Control","9/6/19",-17,37430574,36282886,"3",1623284,"Farm A","Sample",-39,"-6",34659602,"USDA1890"
"USDA1893","35786","2","Control","8/3/19",-32,29223173,28348497,"1",4498644,"Farm A","Sample",-34,"-5",23849853,"USDA1893"
"USDA1894","84133","7","Control","8/2/19",-31,24794485,24182082,"3",1296270,"Farm A","Sample",-38,"-6",22885812,"USDA1894"
"USDA1910","23062","3","Control","5/24/19",-1,32466309,31550070,"1",30847718,"Farm B","Sample",-4,"-1",702352,"USDA1910"
"USDA1911","23760","18","Case","5/23/19",0,33752942,32983984,"1",5292208,"Farm B","Sample",-18,"-3",27691776,"USDA1911"
"USDA1912","23768","0","Case","5/27/19",-4,31501527,30663940,"3",14279818,"Farm B","Sample",-4,"-1",16384122,"USDA1912"
"USDA1916","23642","3","Control","5/31/19",-8,29073249,28392208,"1",5380680,"Farm B","Sample",-11,"-2",23011528,"USDA1916"
"USDA1919","23358","1","Control","5/29/19",-6,26999622,26393451,"3",525456,"Farm B","Sample",-7,"-1",25867995,"USDA1919"
"USDA1920","23980","1","Case","6/9/19",-17,32104754,31461608,"1",429523,"Farm B","Sample",-18,"-3",31032085,"USDA1920"
"USDA1923","23819","10","Control","5/31/19",-8,29818002,29129338,"2",378593,"Farm B","Sample",-18,"-3",28750745,"USDA1923"
"USDA1957","23701","2","Control","4/30/19",2,21774064,20775443,"1",15549963,"Farm B","Sample",0,"-1",5225480,"USDA1957"
"USDA1962","23614","4","Control","5/5/19",4,32670896,31961503,"2",18708771,"Farm B","Sample",0,"-1",13252732,"USDA1962"
"USDA1963","23748","25","Control","5/9/19",0,30277799,29584609,"3",28046201,"Farm B","Sample",-25,"-4",1538408,"USDA1963"
"USDA1966","23813","2","Case","5/11/19",-2,27205586,26325251,"2",6698584,"Farm B","Sample",-4,"-1",19626667,"USDA1966"
"USDA1967","23962","1","Case","5/12/19",-3,32119916,31256786,"3",23571184,"Farm B","Sample",-4,"-1",7685602,"USDA1967"
"USDA1973","5652","5","Control","11/3/19",5,31185250,30612294,"1",93471,"Farm C","Sample",0,"-1",30518823,"USDA1973"
"USDA1974","5844","12","Control","11/3/19",5,45180921,43030602,"2",2864109,"Farm C","Sample",-7,"-1",40166493,"USDA1974"
"USDA2005","23831","18","Control","5/9/19",0,38287010,37307277,"1",21000199,"Farm B","Sample",-18,"-3",16307078,"USDA2005"
"USDA2020","23748","25","Control","5/9/19",11,26922868,26285132,"2",4958747,"Farm B","Sample",-14,"-2",21326385,"USDA2020"
"USDA2023","23744","4","Control","5/23/19",-14,27586552,27070364,"1",679953,"Farm B","Sample",-18,"-3",26390411,"USDA2023"
"USDA2031","5658","15","Control","12/5/19",-28,28270312,27537562,"2",251532,"Farm C","Sample",-43,"â‰¥ -7",27286030,"USDA2031"
"USDA2032","5420","16","Case","11/27/19",-20,25749238,25024033,"2",137872,"Farm C","Sample",-36,"-6",24886161,"USDA2032"
"USDA2051","5802","7","Control","11/20/19",-13,30832963,29353043,"2",115782,"Farm C","Sample",-20,"-3",29237261,"USDA2051"
"USDA2064","5635","2","Case","12/11/19",-34,27942447,27072729,"2",624544,"Farm C","Sample",-36,"-6",26448185,"USDA2064"
"USDA2065","23784","3","Control","5/17/19",-8,43992674,42583521,"2",1249620,"Farm B","Sample",-11,"-2",41333901,"USDA2065"
"USDA2067","23751","5","Control","5/15/19",-6,26803664,26159359,"2",25303568,"Farm B","Sample",-11,"-2",855791,"USDA2067"
"USDA2077","5420","16","Case","11/27/19",16,42558039,40872128,"2",257689,"Farm C","Sample",0,"-1",40614439,"USDA2077"
"USDA2079","5658","15","Control","12/5/19",8,32934305,32103942,"3",12703311,"Farm C","Sample",-7,"-1",19400631,"USDA2079"
"USDA2091","5382","8","Case","12/5/19",8,25749357,24507553,"2",1211360,"Farm C","Sample",0,"-1",23296193,"USDA2091"
"USDA2125","23915","25","Case","5/9/19",0,39781810,38726172,"1",27539623,"Farm B","Sample",-25,"-4",11186549,"USDA2125"
"USDA2126","23456","1","Case","5/22/19",-13,28107528,27490235,"1",15485963,"Farm B","Sample",-14,"-2",12004272,"USDA2126"
"USDA2127","23268","4","Case","5/16/19",-7,29014688,28386564,"3",570830,"Farm B","Sample",-11,"-2",27815734,"USDA2127"
"USDA2129","23577","4","Case","5/30/19",-21,30306602,29596863,"3",1338997,"Farm B","Sample",-25,"-4",28257866,"USDA2129"
"USDA2132","23831","18","Control","5/9/19",11,28741114,28230612,"2",7081865,"Farm B","Sample",-7,"-1",21148747,"USDA2132"
"USDA2133","23277","29","Control","4/28/19",22,31254691,30443331,"1",2240685,"Farm B","Sample",-7,"-1",28202646,"USDA2133"
"USDA2137","5635","2","Case","12/11/19",2,29376538,28636174,"2",7875736,"Farm C","Sample",0,"-1",20760438,"USDA2137"
"USDA2146","5386","1","Case","10/10/19",1,20614096,20081241,"1",92541,"Farm C","Sample",0,"-1",19988700,"USDA2146"
"USDA2176","5527","7","Case","10/4/19",7,42336300,41450574,"2",442308,"Farm C","Sample",0,"-1",41008266,"USDA2176"
"USDA2184","5460","3","Control","10/8/19",3,29170919,28447305,"3",168674,"Farm C","Sample",0,"-1",28278631,"USDA2184"
"USDA2185","24049","0","Case","5/27/19",-18,29629688,28349247,"2",13080965,"Farm B","Sample",-18,"-3",15268282,"USDA2185"
"USDA2186","23877","7","Case","5/20/19",-11,42776,35750,"3",6030,"Farm B","Sample",-18,"-3",29720,"USDA2186"
"USDA2187","23620","1","Case","5/15/19",-6,23274440,22547345,"2",4560125,"Farm B","Sample",-7,"-1",17987220,"USDA2187"
"USDA2188","23062","3","Control","5/24/19",-15,33977791,33202685,"3",9364045,"Farm B","Sample",-18,"-3",23838640,"USDA2188"
"USDA2189","23760","18","Case","5/23/19",-14,24476388,23534305,"2",4444516,"Farm B","Sample",-32,"-5",19089789,"USDA2189"
"USDA2191","23277","29","Control","4/28/19",-17,36643770,35573860,"1",1013755,"Farm B","Sample",-46,"â‰¥ -7",34560105,"USDA2191"
"USDA2193","23730","6","Control","4/13/19",-2,41339463,40561202,"1",7620471,"Farm B","Sample",-8,"-2",32940731,"USDA2193"
"USDA2204","23730","6","Control","4/13/19",-23,25609085,25014338,"2",201477,"Farm B","Sample",-29,"-5",24812861,"USDA2204"
"USDA2205","23345","4","Case","4/15/19",-25,32842636,31977250,"2",20042154,"Farm B","Sample",-29,"-5",11935096,"USDA2205"
"USDA2206","23724","16","Case","4/9/19",-19,26105122,25444115,"3",5154697,"Farm B","Sample",-35,"-5",20289418,"USDA2206"
"USDA2207","23025","1","Control","4/3/19",-13,35501324,34763717,"3",6865449,"Farm B","Sample",-14,"-2",27898268,"USDA2207"
"USDA2208","23043","6","Control","4/23/19",-33,26595680,26074234,"1",6576668,"Farm B","Sample",-39,"-6",19497566,"USDA2208"
"USDA2210","23915","25","Case","5/9/19",4,26523165,25993018,"1",3577917,"Farm B","Sample",-21,"-3",22415101,"USDA2210"
"USDA2214","23144","3","Control","4/26/19",-22,38604442,37616268,"3",7827268,"Farm B","Sample",-25,"-4",29789000,"USDA2214"
"USDA2221","23043","6","Control","4/23/19",-12,36076366,35416293,"1",637672,"Farm B","Sample",-18,"-3",34778621,"USDA2221"
"USDA2222","23345","4","Case","4/15/19",-4,35340271,34611707,"1",8360000,"Farm B","Sample",-8,"-2",26251707,"USDA2222"
"USDA2223","23724","16","Case","4/9/19",2,26803502,26280154,"1",496363,"Farm B","Sample",-14,"-2",25783791,"USDA2223"
"USDA2225","23915","25","Case","5/9/19",11,31775892,31034422,"3",1024185,"Farm B","Sample",-14,"-2",30010237,"USDA2225"
"USDA2228","23768","0","Case","5/27/19",-18,25844413,25182796,"2",8763461,"Farm B","Sample",-18,"-3",16419335,"USDA2228"
"USDA2231","23979","1","Control","5/29/19",-20,46009224,44213201,"2",2629053,"Farm B","Sample",-21,"-3",41584148,"USDA2231"
"USDA2241","23787","4","Case","4/19/19",-29,29936648,29353688,"3",155440,"Farm B","Sample",-33,"-5",29198248,"USDA2241"
"USDA2244","23754","5","Case","4/13/19",-23,36955159,35908049,"2",2857372,"Farm B","Sample",-28,"-4",33050677,"USDA2244"
"USDA2252","5439","9","Control","11/18/19",-11,27843513,27268273,"2",160130,"Farm C","Sample",-20,"-3",27108143,"USDA2252"
"USDA2256","5382","8","Case","12/5/19",-28,26660937,26089454,"1",127324,"Farm C","Sample",-36,"-6",25962130,"USDA2256"
"USDA2258","5718","2","Control","11/25/19",-18,33416165,32085946,"2",162093,"Farm C","Sample",-20,"-3",31923853,"USDA2258"
"USDA2271","83657","8","Case","8/1/19",-30,26202190,25376898,"1",2769068,"Farm A","Sample",-38,"-6",22607830,"USDA2271"
"USDA2283","5049","12","Case","10/20/19",-24,43242156,41560667,"2",1281215,"Farm C","Sample",-36,"-6",40279452,"USDA2283"
"USDA2302","5386","1","Case","10/10/19",-14,43064612,41543893,"3",8327507,"Farm C","Sample",-15,"-3",33216386,"USDA2302"
"USDA2304","5541","4","Control","10/28/19",-32,32736026,31362436,"1",1731758,"Farm C","Sample",-36,"-6",29630678,"USDA2304"
"USDA2316","5527","7","Case","10/4/19",-8,46335422,45401253,"2",337443,"Farm C","Sample",-15,"-3",45063810,"USDA2316"
"USDA2317","5537","3","Case","10/22/19",-26,25080794,24549924,"2",103455,"Farm C","Sample",-29,"-5",24446469,"USDA2317"
"USDA2339","5718","2","Control","11/25/19",-18,27614559,27023595,"2",383845,"Farm C","Sample",-20,"-3",26639750,"USDA2339"
"USDA2346","5658","15","Control","12/5/19",15,24877327,24285999,"1",2892095,"Farm C","Sample",0,"-1",21393904,"USDA2346"
"USDA2363","5460","3","Control","10/8/19",-12,44348336,43088953,"3",5999580,"Farm C","Sample",-15,"-3",37089373,"USDA2363"
"USDA2365","5844","12","Control","11/3/19",-17,36175617,35239563,"3",6332135,"Farm C","Sample",-29,"-5",28907428,"USDA2365"
"USDA2369","5802","7","Control","11/20/19",-34,26423757,25795633,"3",90362,"Farm C","Sample",-41,"-6",25705271,"USDA2369"
"USDA2400","5049","12","Case","10/20/19",-3,26735812,26084507,"3",4156684,"Farm C","Sample",-15,"-3",21927823,"USDA2400"
"USDA2405","5652","5","Control","11/3/19",-17,30415520,29610048,"3",832865,"Farm C","Sample",-22,"-4",28777183,"USDA2405"
"USDA2422","5541","4","Control","10/28/19",-11,29048210,28426286,"2",309442,"Farm C","Sample",-15,"-3",28116844,"USDA2422"
"USDA2437","5635","2","Case","12/11/19",-14,35112880,34302910,"3",16639693,"Farm C","Sample",-16,"-3",17663217,"USDA2437"
"USDA2442","5658","15","Control","12/5/19",-8,37812862,36826777,"2",4538752,"Farm C","Sample",-23,"-4",32288025,"USDA2442"
"USDA2458","5505","1","Case","9/26/19",0,21271923,20678453,"2",235985,"Farm C","Sample",-1,"-1",20442468,"USDA2458"
"USDA2470","5537","3","Case","10/22/19",-5,29317511,28641564,"1",5075697,"Farm C","Sample",-8,"-2",23565867,"USDA2470"
"USDA2498","5541","4","Control","10/28/19",4,39841586,38817884,"1",12961124,"Farm C","Sample",0,"-1",25856760,"USDA2498"
"USDA2504","5049","12","Case","10/20/19",12,40327469,39033428,"2",1539166,"Farm C","Sample",0,"-1",37494262,"USDA2504"
"USDA2510","5420","16","Case","11/27/19",0,34948957,33072656,"1",4093095,"Farm C","Sample",-16,"-3",28979561,"USDA2510"
"USDA2517","5382","8","Case","12/5/19",-8,33435699,32517121,"1",20881098,"Farm C","Sample",-16,"-3",11636023,"USDA2517"
"USDA2533","23111","2","Case","5/25/19",-23,33156538,32392218,"3",25779811,"Farm B","Sample",-25,"-4",6612407,"USDA2533"
"USDA2535","23819","10","Control","5/31/19",-29,36519760,35447144,"2",808777,"Farm B","Sample",-39,"-6",34638367,"USDA2535"
"USDA2536","23357","0","Case","6/3/19",-32,33800741,32504245,"1",8542863,"Farm B","Sample",-32,"-5",23961382,"USDA2536"
"USDA2538","24236","2","Control","6/4/19",-33,35248657,34612673,"1",2057833,"Farm B","Sample",-35,"-5",32554840,"USDA2538"
"USDA2540","23620","1","Case","5/15/19",-13,34663902,33903899,"3",2147459,"Farm B","Sample",-14,"-2",31756440,"USDA2540"
"USDA2541","23586","1","Case","5/29/19",-27,33519679,32852933,"1",1750704,"Farm B","Sample",-28,"-4",31102229,"USDA2541"
"USDA2543","23909","32","Case","6/1/19",-30,31576734,29823224,"2",2341843,"Farm B","Sample",-62,"â‰¥ -7",27481381,"USDA2543"
"USDA2586","5420","16","Case","11/27/19",8,22980857,22339108,"2",572350,"Farm C","Sample",-8,"-2",21766758,"USDA2586"
"USDA2609","5658","15","Control","12/5/19",-14,29126527,28585191,"1",3813560,"Farm C","Sample",-29,"-5",24771631,"USDA2609"
"USDA2620","5845","25","Control","7/25/19",-23,30929177,29006767,"2",9629765,"Farm A","Sample",-48,"â‰¥ -7",19377002,"USDA2620"
"USDA2624","68481","4","Case","8/11/19",-33,32934605,31950735,"1",9292566,"Farm A","Sample",-37,"-6",22658169,"USDA2624"
"USDA2627","5798","6","Case","8/9/19",-31,31997264,31130267,"3",13370456,"Farm A","Sample",-37,"-6",17759811,"USDA2627"
"USDA2629","84156","6","Control","7/30/19",-14,32721662,31758986,"1",16751810,"Farm A","Sample",-20,"-3",15007176,"USDA2629"
"USDA2636","87221","19","Control","8/26/19",-6,37476284,36431095,"3",30197490,"Farm A","Sample",-25,"-4",6233605,"USDA2636"
"USDA2648","84156","6","Control","7/30/19",-28,45046270,41856669,"2",22133481,"Farm A","Sample",-34,"-5",19723188,"USDA2648"
"USDA2649","93514","25","Case","8/1/19",-30,38560602,37675343,"2",5051186,"Farm A","Sample",-55,"â‰¥ -7",32624157,"USDA2649"
"USDA2651","5814","7","Control","8/2/19",-31,29942436,29351748,"1",2791742,"Farm A","Sample",-38,"-6",26560006,"USDA2651"
"USDA2657","8431","5","Control","5/25/19",5,24125243,23480056,"1",6491143,"Farm D","Sample",0,"-1",16988913,"USDA2657"
"USDA2659","1760","7","Control","5/23/19",7,45642215,44776350,"1",55564,"Farm D","Sample",0,"-1",44720786,"USDA2659"
"USDA2665","1703","0","Control","3/29/19",-35,37678945,36704732,"3",6126762,"Farm D","Sample",-35,"-5",30577970,"USDA2665"
"USDA2671","1736","14","Control","3/22/19",-28,37987052,36939137,"1",35640402,"Farm D","Sample",-42,"-6",1298735,"USDA2671"
"USDA2679","84956","17","Case","9/17/19",-28,32841411,31835188,"3",26643831,"Farm A","Sample",-45,"â‰¥ -7",5191357,"USDA2679"
"USDA2688","84771","5","Control","8/10/19",-32,25531302,24953272,"2",317842,"Farm A","Sample",-37,"-6",24635430,"USDA2688"
"USDA2706","83657","8","Case","8/1/19",-16,37515908,36516914,"2",27391207,"Farm A","Sample",-24,"-4",9125707,"USDA2706"
"USDA2707","84697","4","Case","8/5/19",4,30065338,29156987,"1",18034107,"Farm A","Sample",0,"-1",11122880,"USDA2707"
"USDA2710","93514","25","Case","8/1/19",8,25948249,25410648,"1",3354927,"Farm A","Sample",-17,"-3",22055721,"USDA2710"
"USDA2711","5814","7","Control","8/2/19",7,26667368,25894571,"1",16973640,"Farm A","Sample",0,"-1",8920931,"USDA2711"
"USDA2720","5845","25","Control","7/25/19",7,41501968,38407271,"2",7178964,"Farm A","Sample",-18,"-3",31228307,"USDA2720"
"USDA2723","84133","7","Control","8/2/19",7,38401203,36659375,"3",9028862,"Farm A","Sample",0,"-1",27630513,"USDA2723"
"USDA2724","83657","8","Case","8/1/19",8,26163396,25520524,"1",8237905,"Farm A","Sample",0,"-1",17282619,"USDA2724"
"USDA2726","35786","2","Control","8/3/19",2,43636662,42542205,"3",26245592,"Farm A","Sample",0,"-1",16296613,"USDA2726"
"USDA2728","5845","25","Control","7/25/19",11,34234724,33082580,"1",14562404,"Farm A","Sample",-14,"-2",18520176,"USDA2728"
"USDA2730","84156","6","Control","7/30/19",6,29136700,28302734,"1",6037031,"Farm A","Sample",0,"-1",22265703,"USDA2730"
"USDA2734","84133","7","Control","8/2/19",-17,35084991,34194597,"3",2499731,"Farm A","Sample",-24,"-4",31694866,"USDA2734"
"USDA2736","5845","25","Control","7/25/19",-9,24847709,24172951,"1",5875295,"Farm A","Sample",-34,"-5",18297656,"USDA2736"
"USDA2751","5845","25","Control","7/25/19",18,26536872,26034803,"1",3304575,"Farm A","Sample",-7,"-1",22730228,"USDA2751"
"USDA2756","84446","7","Case","8/16/19",-31,30719423,29851519,"2",27454200,"Farm A","Sample",-38,"-6",2397319,"USDA2756"
"USDA2762","5431","13","Case","9/21/19",-9,26633652,25784629,"2",22784244,"Farm C","Sample",-22,"-4",3000385,"USDA2762"
"USDA2764","5527","7","Case","10/4/19",-22,29453948,28715753,"3",4320602,"Farm C","Sample",-29,"-5",24395151,"USDA2764"
"USDA2769","23277","29","Control","4/28/19",15,29248133,28521830,"2",2750778,"Farm B","Sample",-14,"-2",25771052,"USDA2769"
"USDA2776","24157","6","Case","5/7/19",6,43096583,40448318,"1",21314548,"Farm B","Sample",0,"-1",19133770,"USDA2776"
"USDA2778","23813","2","Case","5/11/19",2,28809320,28064755,"2",14719292,"Farm B","Sample",0,"-1",13345463,"USDA2778"
"USDA2797","5802","7","Control","11/20/19",2,31802225,30947911,"3",588153,"Farm C","Sample",-5,"-1",30359758,"USDA2797"
"USDA2805","5505","1","Case","9/26/19",-14,39612521,38555388,"1",4602782,"Farm C","Sample",-15,"-3",33952606,"USDA2805"
"USDA2808","5460","3","Control","10/8/19",-26,41438992,40396274,"1",4532644,"Farm C","Sample",-29,"-5",35863630,"USDA2808"
"USDA2817","23100","11","Control","5/30/19",4,25355857,24713196,"3",7641326,"Farm B","Sample",-7,"-1",17071870,"USDA2817"
"USDA2821","23357","0","Case","6/3/19",0,37767450,36013215,"2",30050115,"Farm B","Sample",0,"-1",5963100,"USDA2821"
"USDA2822","23917","1","Case","6/2/19",1,26349612,25295564,"2",18841311,"Farm B","Sample",0,"-1",6454253,"USDA2822"
"USDA2836","93514","25","Case","8/1/19",11,25322510,24796636,"1",7198476,"Farm A","Sample",-14,"-2",17598160,"USDA2836"
"USDA2840","69116","7","Case","8/30/19",-24,28694713,28014515,"1",2858983,"Farm A","Sample",-31,"-5",25155532,"USDA2840"
"USDA2842","84771","5","Control","8/10/19",-4,23860848,23390524,"1",1747506,"Farm A","Sample",-9,"-2",21643018,"USDA2842"
"USDA2852","5814","7","Control","8/2/19",-17,34492894,32889584,"2",1753938,"Farm A","Sample",-24,"-4",31135646,"USDA2852"
"USDA2853","35786","2","Control","8/3/19",-18,23866442,22984946,"2",6587385,"Farm A","Sample",-20,"-3",16397561,"USDA2853"
"USDA2864","5573","1","Control","9/26/19",-14,33977820,32648930,"2",645780,"Farm C","Sample",-15,"-3",32003150,"USDA2864"
"USDA2871","68688","13","Case","8/31/19",-25,27795638,27075647,"2",17079816,"Farm A","Sample",-38,"-6",9995831,"USDA2871"
"USDA2875","5798","6","Case","8/9/19",-3,24519204,23669520,"2",4013954,"Farm A","Sample",-9,"-2",19655566,"USDA2875"
"USDA2888","23980","1","Case","6/9/19",-3,25833728,25252446,"3",220822,"Farm B","Sample",-4,"-1",25031624,"USDA2888"
"USDA2892","23792","5","Control","6/12/19",-6,21051586,20206038,"2",255443,"Farm B","Sample",-11,"-2",19950595,"USDA2892"
"USDA2893","24012","2","Control","6/11/19",-5,25788776,25171597,"3",3674813,"Farm B","Sample",-7,"-1",21496784,"USDA2893"
"USDA2895","23883","0","Control","6/10/19",-4,29278858,28695049,"2",248712,"Farm B","Sample",-4,"-1",28446337,"USDA2895"
"USDA2902","23748","25","Control","5/9/19",25,28982804,27944032,"2",5781154,"Farm B","Sample",0,"-1",22162878,"USDA2902"
"USDA2912","23577","4","Case","5/30/19",4,34772882,33351022,"1",28862185,"Farm B","Sample",0,"-1",4488837,"USDA2912"
"USDA2913","23909","32","Case","6/1/19",2,31620185,30742822,"2",28458921,"Farm B","Sample",-30,"-5",2283901,"USDA2913"
"USDA2922","5541","4","Control","10/28/19",-24,24832639,24165543,"2",112783,"Farm C","Sample",-28,"-4",24052760,"USDA2922"
"USDA2932","23831","18","Control","5/9/19",4,25821011,25259220,"1",15050290,"Farm B","Sample",-14,"-2",10208930,"USDA2932"
"USDA2933","23748","25","Control","5/9/19",4,27961802,27208766,"2",23532478,"Farm B","Sample",-21,"-3",3676288,"USDA2933"
"USDA2951","23883","0","Control","6/10/19",0,34180611,33477674,"1",18467663,"Farm B","Sample",0,"-1",15010011,"USDA2951"
"USDA2977","5537","3","Case","10/22/19",-12,25556462,24690477,"1",4000459,"Farm C","Sample",-15,"-3",20690018,"USDA2977"
"USDA2989","5537","3","Case","10/22/19",-18,30085245,29461715,"1",167463,"Farm C","Sample",-21,"-3",29294252,"USDA2989"
"USDA2997","5844","12","Control","11/3/19",-24,25882241,25295131,"3",1094945,"Farm C","Sample",-36,"-6",24200186,"USDA2997"
"USDA3005","5460","3","Control","10/8/19",-4,31462795,30583147,"1",352421,"Farm C","Sample",-7,"-1",30230726,"USDA3005"
"USDA3009","5652","5","Control","11/3/19",-24,39547982,38643804,"1",1063220,"Farm C","Sample",-29,"-5",37580584,"USDA3009"
"USDA3057","5386","1","Case","10/10/19",0,52282014,49810486,"1",4168788,"Farm C","Sample",-1,"-1",45641698,"USDA3057"
"USDA3079","5541","4","Control","10/28/19",-18,29925733,29402255,"1",139686,"Farm C","Sample",-22,"-4",29262569,"USDA3079"
"USDA3092","23792","5","Control","6/12/19",5,30023549,29175996,"1",3415572,"Farm B","Sample",0,"-1",25760424,"USDA3092"
"USDA3097","23980","1","Case","6/9/19",1,31250298,30382347,"2",28659215,"Farm B","Sample",0,"-1",1723132,"USDA3097"
"USDA3147","23812","2","Control","5/28/19",-26,38994317,37896459,"3",1172720,"Farm B","Sample",-28,"-4",36723739,"USDA3147"
"USDA3148","23872","11","Case","5/23/19",-21,30338567,29586187,"3",3086021,"Farm B","Sample",-32,"-5",26500166,"USDA3148"
"USDA3149","23808","3","Case","5/24/19",-22,32097846,30996308,"1",1321107,"Farm B","Sample",-25,"-4",29675201,"USDA3149"
"USDA3151","23730","6","Control","4/13/19",2,36690113,35415587,"1",28673799,"Farm B","Sample",-4,"-1",6741788,"USDA3151"
"USDA3158","5718","2","Control","11/25/19",-4,27169392,26533247,"3",385474,"Farm C","Sample",-6,"-1",26147773,"USDA3158"
"USDA3178","5382","8","Case","12/5/19",-14,30156492,29558313,"1",1255134,"Farm C","Sample",-22,"-4",28303179,"USDA3178"
"USDA3227","5802","7","Control","11/20/19",-20,24538161,23848181,"2",428122,"Farm C","Sample",-27,"-4",23420059,"USDA3227"
"USDA3250","5420","16","Case","11/27/19",-27,29396644,28783305,"1",134623,"Farm C","Sample",-43,"â‰¥ -7",28648682,"USDA3250"
"USDA3255","5537","3","Case","10/22/19",3,27406248,26713335,"1",4475008,"Farm C","Sample",0,"-1",22238327,"USDA3255"
"USDA3289","5382","8","Case","12/5/19",-21,40173699,39418965,"1",403802,"Farm C","Sample",-29,"-5",39015163,"USDA3289"
"USDA3291","5802","7","Control","11/20/19",-6,36496262,35591853,"3",542600,"Farm C","Sample",-13,"-2",35049253,"USDA3291"
"USDA3323","94057","21","Case","8/24/19",-18,29609804,28951636,"3",1525223,"Farm A","Sample",-39,"-6",27426413,"USDA3323"
"USDA3332","94134","22","Control","9/6/19",-31,46290788,45195463,"2",822335,"Farm A","Sample",-53,"â‰¥ -7",44373128,"USDA3332"
"USDA3348","68481","4","Case","8/11/19",-5,22054326,21563647,"1",3558666,"Farm A","Sample",-9,"-2",18004981,"USDA3348"
"USDA3359","84446","7","Case","8/16/19",-9,35022415,34108150,"2",28719854,"Farm A","Sample",-16,"-3",5388296,"USDA3359"
"USDA3382","84521","4","Case","8/26/19",-19,39729708,38628795,"3",7496414,"Farm A","Sample",-23,"-4",31132381,"USDA3382"
"USDA3387","5439","9","Control","11/18/19",-25,25324900,24557345,"2",6729980,"Farm C","Sample",-34,"-5",17827365,"USDA3387"
"USDA3391","5541","4","Control","10/28/19",-4,31047960,30313291,"2",1565559,"Farm C","Sample",-8,"-2",28747732,"USDA3391"
"USDA3422","23807","2","Control","4/23/19",-5,30354549,29705972,"2",597621,"Farm B","Sample",-7,"-1",29108351,"USDA3422"
"USDA3423","23349","4","Case","4/25/19",-7,37803249,35683352,"2",27553891,"Farm B","Sample",-11,"-2",8129461,"USDA3423"
"USDA3425","23419","4","Case","4/25/19",-7,33020100,32311354,"1",20719178,"Farm B","Sample",-11,"-2",11592176,"USDA3425"
"USDA3431","23660","3","Case","4/22/19",-4,34451891,33497941,"1",20618952,"Farm B","Sample",-7,"-1",12878989,"USDA3431"
"USDA3442","94279","14","Control","8/26/19",-19,35143442,34388243,"3",4634644,"Farm A","Sample",-33,"-5",29753599,"USDA3442"
"USDA3445","23872","11","Case","5/23/19",-35,21000111,20566855,"2",750996,"Farm B","Sample",-46,"â‰¥ -7",19815859,"USDA3445"
"USDA3461","23277","29","Control","4/28/19",-10,28292296,27566564,"2",3210718,"Farm B","Sample",-39,"-6",24355846,"USDA3461"
"USDA3464","23043","6","Control","4/23/19",-5,33644961,31503624,"2",6979169,"Farm B","Sample",-11,"-2",24524455,"USDA3464"
"USDA3466","23805","3","Case","4/26/19",-8,32242117,31380408,"2",16908187,"Farm B","Sample",-11,"-2",14472221,"USDA3466"
"USDA3470","23701","2","Control","4/30/19",-12,30352631,28920247,"2",19493574,"Farm B","Sample",-14,"-2",9426673,"USDA3470"
"USDA3472","23740","0","Case","4/29/19",-11,38432968,36577684,"1",21700480,"Farm B","Sample",-11,"-2",14877204,"USDA3472"
"USDA3481","23813","2","Case","5/11/19",-9,28325083,27682186,"1",15304906,"Farm B","Sample",-11,"-2",12377280,"USDA3481"
"USDA3485","23813","2","Case","5/11/19",-23,28087690,27492490,"2",357917,"Farm B","Sample",-25,"-4",27134573,"USDA3485"
"USDA3490","23751","5","Control","5/15/19",-27,33842436,32969715,"3",27020441,"Farm B","Sample",-32,"-5",5949274,"USDA3490"
"USDA3496","23744","4","Control","5/23/19",-35,24171244,23077925,"1",784534,"Farm B","Sample",-39,"-6",22293391,"USDA3496"
"USDA3499","23144","3","Control","4/26/19",-8,31257367,30305882,"3",223142,"Farm B","Sample",-11,"-2",30082740,"USDA3499"
"USDA3506","84568","18","Case","9/21/19",-32,41145890,39881267,"2",34685473,"Farm A","Sample",-50,"â‰¥ -7",5195794,"USDA3506"
"USDA3524","93514","25","Case","8/1/19",-13,30617513,29855560,"3",2376857,"Farm A","Sample",-38,"-6",27478703,"USDA3524"
"USDA3533","1736","14","Control","3/22/19",-35,36678363,35788387,"3",34268987,"Farm D","Sample",-49,"â‰¥ -7",1519400,"USDA3533"
"USDA3536","8431","5","Control","5/25/19",-11,33645558,32930944,"1",159176,"Farm D","Sample",-16,"-3",32771768,"USDA3536"
"USDA3537","1760","7","Control","5/23/19",-9,32795194,32156930,"3",13937,"Farm D","Sample",-16,"-3",32142993,"USDA3537"
"USDA3541","1760","7","Control","5/23/19",-6,22025076,21545845,"2",35473,"Farm D","Sample",-13,"-2",21510372,"USDA3541"
"USDA3549","8438","5","Control","5/5/19",4,38938615,37768641,"2",39370,"Farm D","Sample",-1,"-1",37729271,"USDA3549"
"USDA3552","1716","3","Case","5/7/19",2,36546616,35920639,"1",53924,"Farm D","Sample",-1,"-1",35866715,"USDA3552"
"USDA3553","5844","12","Control","11/3/19",-10,34603070,33768806,"3",2890945,"Farm C","Sample",-22,"-4",30877861,"USDA3553"
"USDA3577","1713","13","Case","3/16/19",-22,28581105,27589174,"2",2172947,"Farm D","Sample",-35,"-5",25416227,"USDA3577"
"USDA3578","1704","2","Case","3/13/19",-19,32094777,31396831,"1",12083805,"Farm D","Sample",-21,"-3",19313026,"USDA3578"
"USDA3581","8433","8","Control","3/28/19",-34,33405058,32508451,"1",490174,"Farm D","Sample",-42,"-6",32018277,"USDA3581"
"USDA3582","8440","8","Control","3/28/19",-34,25413411,24679355,"2",2121309,"Farm D","Sample",-42,"-6",22558046,"USDA3582"
"USDA3583","1724","1","Case","3/28/19",-34,25870843,25149819,"1",16907178,"Farm D","Sample",-35,"-5",8242641,"USDA3583"
"USDA3587","1706","2","Case","3/19/19",-25,16934578,16535267,"3",7893484,"Farm D","Sample",-27,"-4",8641783,"USDA3587"
"USDA3597","5652","5","Control","11/3/19",-10,39056124,37918313,"1",854032,"Farm C","Sample",-15,"-3",37064281,"USDA3597"
"USDA3640","93514","25","Case","8/1/19",25,25307877,24533030,"1",4610549,"Farm A","Sample",0,"-1",19922481,"USDA3640"
"USDA3644","69116","7","Case","8/30/19",7,37320886,36402493,"2",25022815,"Farm A","Sample",0,"-1",11379678,"USDA3644"
"USDA3654","69116","7","Case","8/30/19",-9,29391601,28594807,"3",3279993,"Farm A","Sample",-16,"-3",25314814,"USDA3654"
"USDA3656","84738","21","Case","9/7/19",-3,27149831,26522735,"1",14581198,"Farm A","Sample",-24,"-4",11941537,"USDA3656"
"USDA3658","84741","24","Case","9/12/19",-8,28126588,27592454,"1",5554969,"Farm A","Sample",-32,"-5",22037485,"USDA3658"
"USDA3660","84568","18","Case","9/21/19",-17,35553765,34078844,"2",10861012,"Farm A","Sample",-35,"-5",23217832,"USDA3660"
"USDA3668","5658","15","Control","12/5/19",0,23755438,23217844,"2",3526950,"Farm C","Sample",-15,"-3",19690894,"USDA3668"
"USDA3674","5652","5","Control","11/3/19",-3,35852140,34989940,"1",743392,"Farm C","Sample",-8,"-2",34246548,"USDA3674"
"USDA3682","5844","12","Control","11/3/19",-3,29184841,28608087,"1",329755,"Farm C","Sample",-15,"-3",28278332,"USDA3682"
"USDA3685","5382","8","Case","12/5/19",-35,40423667,39381743,"1",439663,"Farm C","Sample",-43,"â‰¥ -7",38942080,"USDA3685"
"USDA3686","5718","2","Control","11/25/19",-25,32771061,31976146,"3",706957,"Farm C","Sample",-27,"-4",31269189,"USDA3686"
"USDA3695","5049","12","Case","10/20/19",5,27978129,27219664,"3",1641099,"Farm C","Sample",-7,"-1",25578565,"USDA3695"
"USDA3713","5439","9","Control","11/18/19",-18,28653475,27772859,"2",123752,"Farm C","Sample",-27,"-4",27649107,"USDA3713"
"USDA3735","85111","6","Case","9/23/19",-19,21383497,20825320,"1",481267,"Farm A","Sample",-25,"-4",20344053,"USDA3735"
"USDA3757","5420","16","Case","11/27/19",-13,31517214,30861935,"3",195918,"Farm C","Sample",-29,"-5",30666017,"USDA3757"
"USDA3760","5718","2","Control","11/25/19",-11,32264701,30778009,"1",1642836,"Farm C","Sample",-13,"-2",29135173,"USDA3760"
"USDA3766","5439","9","Control","11/18/19",-4,22153121,21636525,"3",147973,"Farm C","Sample",-13,"-2",21488552,"USDA3766"
"USDA3769","5635","2","Case","12/11/19",-27,43317294,42192110,"3",2185659,"Farm C","Sample",-29,"-5",40006451,"USDA3769"
"USDA3771","5658","15","Control","12/5/19",-21,34411807,33711707,"1",1178390,"Farm C","Sample",-36,"-6",32533317,"USDA3771"
"USDA3801","5635","2","Case","12/11/19",-20,35092898,34427063,"1",3765986,"Farm C","Sample",-22,"-4",30661077,"USDA3801"
"USDA3805","8444","6","Control","3/23/19",-29,34095195,33220315,"2",11323464,"Farm D","Sample",-35,"-5",21896851,"USDA3805"
"USDA3810","1740","2","Case","3/19/19",-25,34331452,33534209,"2",3737391,"Farm D","Sample",-27,"-4",29796818,"USDA3810"
"USDA3814","1708","0","Case","3/15/19",-21,33617203,32988200,"1",5737980,"Farm D","Sample",-21,"-3",27250220,"USDA3814"
"USDA3820","5505","1","Case","9/26/19",1,31732058,30873669,"3",4611604,"Farm C","Sample",0,"-1",26262065,"USDA3820"
"USDA3822","5431","13","Case","9/21/19",6,21655593,21065044,"2",2162012,"Farm C","Sample",-7,"-1",18903032,"USDA3822"
"USDA3827","5573","1","Control","9/26/19",1,21478051,21007170,"2",1315394,"Farm C","Sample",0,"-1",19691776,"USDA3827"
"USDA3830","93514","25","Case","8/1/19",-9,29223264,28399566,"3",17773066,"Farm A","Sample",-34,"-5",10626500,"USDA3830"
"USDA3846","83657","8","Case","8/1/19",-9,26723266,26169540,"1",13638555,"Farm A","Sample",-17,"-3",12530985,"USDA3846"
"USDA3847","84778","7","Control","10/11/19",4,40263544,39335600,"3",26255469,"Farm A","Sample",-3,"-1",13080131,"USDA3847"
"USDA3870","84521","4","Case","8/26/19",-5,26434651,25827434,"1",252588,"Farm A","Sample",-9,"-2",25574846,"USDA3870"
"USDA3874","93845","5","Case","9/18/19",-14,32803884,31935898,"3",2182685,"Farm A","Sample",-19,"-3",29753213,"USDA3874"
"USDA3883","84133","7","Control","8/2/19",-10,28734996,28005302,"3",1582221,"Farm A","Sample",-17,"-3",26423081,"USDA3883"
"USDA3885","84697","4","Case","8/5/19",-13,22187253,21560157,"2",1354873,"Farm A","Sample",-17,"-3",20205284,"USDA3885"
"USDA3892","68726","21","Case","10/2/19",13,39576707,38722536,"1",15680581,"Farm A","Sample",-8,"-2",23041955,"USDA3892"
"USDA3896","68726","21","Case","10/2/19",-6,43040188,41759429,"1",31848219,"Farm A","Sample",-27,"-4",9911210,"USDA3896"
"USDA3898","84924","7","Case","9/28/19",-2,22237117,21789007,"1",909958,"Farm A","Sample",-9,"-2",20879049,"USDA3898"
"USDA3906","94134","22","Control","9/6/19",-2,31758781,30965790,"3",2024528,"Farm A","Sample",-24,"-4",28941262,"USDA3906"
"USDA3925","84156","6","Control","7/30/19",-7,24828052,23421666,"2",937437,"Farm A","Sample",-13,"-2",22484229,"USDA3925"
"USDA3932","85135","8","Control","9/21/19",-17,26444509,25782722,"1",1782609,"Farm A","Sample",-25,"-4",24000113,"USDA3932"
"USDA3939","69228","25","Case","9/28/19",-2,28426123,27885477,"1",1532066,"Farm A","Sample",-27,"-4",26353411,"USDA3939"
"USDA3941","84778","7","Control","10/11/19",-15,32022930,31363031,"2",1467454,"Farm A","Sample",-22,"-4",29895577,"USDA3941"
"USDA3947","93780","18","Control","10/5/19",-32,37615769,36702370,"3",32592195,"Farm A","Sample",-50,"â‰¥ -7",4110175,"USDA3947"
"USDA3960","84901","11","Control","9/28/19",-2,36587380,35837856,"1",31229262,"Farm A","Sample",-13,"-2",4608594,"USDA3960"
"USDA3963","87216","15","Case","10/3/19",-7,28441606,27579537,"2",6060484,"Farm A","Sample",-22,"-4",21519053,"USDA3963"
"USDA3993","68481","4","Case","8/11/19",4,34790776,33752023,"2",30927387,"Farm A","Sample",0,"-1",2824636,"USDA3993"
"USDA3995","84771","5","Control","8/10/19",5,32430758,31683776,"2",14330351,"Farm A","Sample",0,"-1",17353425,"USDA3995"
"USDA3996","5798","6","Case","8/9/19",6,34506379,33241216,"1",10326534,"Farm A","Sample",0,"-1",22914682,"USDA3996"
"USDA3997","94279","14","Control","8/26/19",-5,24890936,24337335,"1",179910,"Farm A","Sample",-19,"-3",24157425,"USDA3997"
"USDA4003","69228","25","Case","9/28/19",25,37850723,36693179,"2",7138819,"Farm A","Sample",0,"-1",29554360,"USDA4003"
"USDA4004","68726","21","Case","10/2/19",21,33181543,32148981,"1",9056220,"Farm A","Sample",0,"-1",23092761,"USDA4004"
"USDA4007","69002","21","Control","10/11/19",12,36537778,35662273,"2",13577464,"Farm A","Sample",-9,"-2",22084809,"USDA4007"
"USDA4010","94122","23","Control","10/14/19",9,31665510,30836695,"2",13956228,"Farm A","Sample",-14,"-2",16880467,"USDA4010"
"USDA4019","94057","21","Case","8/24/19",-3,29027496,28268770,"3",6742061,"Farm A","Sample",-24,"-4",21526709,"USDA4019"
"USDA4028","93780","18","Control","10/5/19",18,32315493,31311400,"1",25123864,"Farm A","Sample",0,"-1",6187536,"USDA4028"
"USDA4032","93745","17","Control","10/15/19",8,33837206,33047347,"1",15769865,"Farm A","Sample",-9,"-2",17277482,"USDA4032"
"USDA4042","93514","25","Case","8/1/19",25,23334426,22386740,"2",3611291,"Farm A","Sample",0,"-1",18775449,"USDA4042"
"USDA4048","94279","14","Control","8/26/19",-34,31213536,29488202,"2",3614456,"Farm A","Sample",-48,"â‰¥ -7",25873746,"USDA4048"
"USDA4067","84753","7","Control","8/30/19",7,30345019,29635268,"1",13907643,"Farm A","Sample",0,"-1",15727625,"USDA4067"
"USDA4093","5814","7","Control","8/2/19",-10,24764503,23973743,"2",322242,"Farm A","Sample",-17,"-3",23651501,"USDA4093"
"USDA4095","35786","2","Control","8/3/19",-11,28470849,27132789,"2",10784036,"Farm A","Sample",-13,"-2",16348753,"USDA4095"
"USDA4101","94122","23","Control","10/14/19",4,36016557,35173768,"2",7418946,"Farm A","Sample",-19,"-3",27754822,"USDA4101"
"USDA4106","5798","6","Case","8/9/19",-17,31586144,30163922,"3",10683572,"Farm A","Sample",-23,"-4",19480350,"USDA4106"
"USDA4110","94057","21","Case","8/24/19",-32,29432088,28589378,"2",11575833,"Farm A","Sample",-53,"â‰¥ -7",17013545,"USDA4110"
"USDA4111","93745","17","Control","10/15/19",3,27997578,27392437,"1",8931049,"Farm A","Sample",-14,"-2",18461388,"USDA4111"
"USDA4113","84778","7","Control","10/11/19",7,32891788,32128305,"1",13608283,"Farm A","Sample",0,"-1",18520022,"USDA4113"
"USDA4116","87216","15","Case","10/3/19",15,46901327,45701480,"1",32325367,"Farm A","Sample",0,"-1",13376113,"USDA4116"
"USDA4125","69002","21","Control","10/11/19",7,52194841,49144045,"2",6568881,"Farm A","Sample",-14,"-2",42575164,"USDA4125"
"USDA4132","5845","25","Control","7/25/19",-2,22163339,21684386,"2",835910,"Farm A","Sample",-27,"-4",20848476,"USDA4132"
"USDA4149","68726","21","Case","10/2/19",-29,34884731,34189589,"1",7830789,"Farm A","Sample",-50,"â‰¥ -7",26358800,"USDA4149"
"USDA4151","84924","7","Case","9/28/19",-25,24385128,23192679,"2",1230202,"Farm A","Sample",-32,"-5",21962477,"USDA4151"
"USDA4157","69228","25","Case","9/28/19",18,26967370,25870317,"1",5648697,"Farm A","Sample",-7,"-1",20221620,"USDA4157"
"USDA4162","84901","11","Control","9/28/19",-25,31653894,30821114,"1",6634652,"Farm A","Sample",-36,"-6",24186462,"USDA4162"
"USDA4163","68726","21","Case","10/2/19",10,43462445,42654506,"1",12973623,"Farm A","Sample",-11,"-2",29680883,"USDA4163"
"USDA4164","68923","7","Control","10/5/19",7,36850315,35848523,"2",35295610,"Farm A","Sample",0,"-1",552913,"USDA4164"
"USDA4169","94122","23","Control","10/14/19",23,28536173,27543425,"2",4691313,"Farm A","Sample",0,"-1",22852112,"USDA4169"
"USDA4173","93780","18","Control","10/5/19",11,30210005,29589891,"1",16536253,"Farm A","Sample",-7,"-1",13053638,"USDA4173"
"USDA4187","84771","5","Control","8/10/19",-18,28449957,27116907,"2",3365131,"Farm A","Sample",-23,"-4",23751776,"USDA4187"
"USDA4217","85111","6","Case","9/23/19",6,35479833,34503891,"3",15764162,"Farm A","Sample",0,"-1",18739729,"USDA4217"
"USDA4232","93745","17","Control","10/15/19",-28,29497947,28853575,"2",678668,"Farm A","Sample",-45,"â‰¥ -7",28174907,"USDA4232"
"USDA4237","87216","15","Case","10/3/19",-16,27567642,26920825,"2",7784703,"Farm A","Sample",-31,"-5",19136122,"USDA4237"
"USDA4238","93780","18","Control","10/5/19",-18,28071417,27498416,"1",6540506,"Farm A","Sample",-36,"-6",20957910,"USDA4238"
"USDA4244","94279","14","Control","8/26/19",5,31887119,31121314,"3",18912176,"Farm A","Sample",-9,"-2",12209138,"USDA4244"
"USDA4251","94279","14","Control","8/26/19",-13,22473460,22003809,"1",636743,"Farm A","Sample",-27,"-4",21367066,"USDA4251"
"USDA4257","87221","19","Control","8/26/19",12,45462565,44473866,"2",1976274,"Farm A","Sample",-7,"-1",42497592,"USDA4257"
"USDA4262","93745","17","Control","10/15/19",17,30406173,29733744,"1",11076003,"Farm A","Sample",0,"-1",18657741,"USDA4262"
"USDA4264","69002","21","Control","10/11/19",21,23769987,23245710,"2",1863898,"Farm A","Sample",0,"-1",21381812,"USDA4264"
"USDA4269","93780","18","Control","10/5/19",-6,28367964,27744907,"1",634483,"Farm A","Sample",-24,"-4",27110424,"USDA4269"
"USDA4274","68726","21","Case","10/2/19",-25,25449723,24669362,"2",959832,"Farm A","Sample",-46,"â‰¥ -7",23709530,"USDA4274"
"USDA4278","68923","7","Control","10/5/19",-28,33652368,31530701,"1",220789,"Farm A","Sample",-35,"-5",31309912,"USDA4278"
"USDA4283","94122","23","Control","10/14/19",18,33724528,32906594,"3",4841773,"Farm A","Sample",-5,"-1",28064821,"USDA4283"
"USDA4286","69002","21","Control","10/11/19",-34,40664926,39278099,"3",4644959,"Farm A","Sample",-55,"â‰¥ -7",34633140,"USDA4286"
"USDA4299","94122","23","Control","10/14/19",-15,24212432,23676451,"2",70366,"Farm A","Sample",-38,"-6",23606085,"USDA4299"
"USDA4301","94176","7","Control","10/2/19",-3,30806500,30132591,"2",1213592,"Farm A","Sample",-10,"-2",28918999,"USDA4301"
"USDA4309","68688","13","Case","8/31/19",7,33556534,32731307,"2",22826363,"Farm A","Sample",-6,"-1",9904944,"USDA4309"
"USDA4319","85135","8","Control","9/21/19",8,29008203,27867989,"2",4206188,"Farm A","Sample",0,"-1",23661801,"USDA4319"
"USDA4327","69116","7","Case","8/30/19",-17,35544938,34256620,"2",19781434,"Farm A","Sample",-24,"-4",14475186,"USDA4327"
"USDA4349","94057","21","Case","8/24/19",-11,25176747,24653342,"1",1211476,"Farm A","Sample",-32,"-5",23441866,"USDA4349"
"USDA4355","84753","7","Control","8/30/19",-17,32214926,31056895,"1",1196996,"Farm A","Sample",-24,"-4",29859899,"USDA4355"
"USDA4359","84738","21","Case","9/7/19",-25,26006143,25434016,"1",310349,"Farm A","Sample",-46,"â‰¥ -7",25123667,"USDA4359"
"USDA4368","84446","7","Case","8/16/19",-3,26669346,25966984,"3",713148,"Farm A","Sample",-10,"-2",25253836,"USDA4368"
"USDA4387","84901","11","Control","9/28/19",-10,24135824,23595805,"1",3900231,"Farm A","Sample",-21,"-3",19695574,"USDA4387"
"USDA4391","85111","6","Case","9/23/19",-5,25830362,25298117,"1",829155,"Farm A","Sample",-11,"-2",24468962,"USDA4391"
"USDA4393","84778","7","Control","10/11/19",-23,33745766,32985993,"3",1049576,"Farm A","Sample",-30,"-5",31936417,"USDA4393"
"USDA4398","84924","7","Case","9/28/19",-10,32059623,31283424,"1",9075789,"Farm A","Sample",-17,"-3",22207635,"USDA4398"
"USDA4404","68688","13","Case","8/31/19",-6,30373269,29054813,"2",24119684,"Farm A","Sample",-19,"-3",4935129,"USDA4404"
"USDA4406","84738","21","Case","9/7/19",-13,32552409,31819908,"1",30430867,"Farm A","Sample",-34,"-5",1389041,"USDA4406"
"USDA4411","84753","7","Control","8/30/19",-5,37750372,36788147,"2",414132,"Farm A","Sample",-12,"-2",36374015,"USDA4411"
"USDA4445","84738","21","Case","9/7/19",12,39623676,38742859,"3",11287618,"Farm A","Sample",-9,"-2",27455241,"USDA4445"
"USDA4448","84738","21","Case","9/7/19",2,28901407,28082963,"2",27252242,"Farm A","Sample",-19,"-3",830721,"USDA4448"
"USDA4449","94134","22","Control","9/6/19",3,33643261,32899363,"1",12263876,"Farm A","Sample",-19,"-3",20635487,"USDA4449"
"USDA4454","87215","14","Control","9/9/19",7,41987782,40835507,"1",20298420,"Farm A","Sample",-7,"-1",20537087,"USDA4454"
"USDA4488","5431","13","Case","9/21/19",13,49112496,47425555,"2",539430,"Farm C","Sample",0,"-1",46886125,"USDA4488"
"USDA4516","23345","4","Case","4/15/19",3,28931096,28033625,"2",23237707,"Farm B","Sample",-1,"-1",4795918,"USDA4516"
"USDA4517","23754","5","Case","4/13/19",5,28961902,28271500,"2",20782895,"Farm B","Sample",0,"-1",7488605,"USDA4517"
"USDA4518","23645","1","Control","4/18/19",0,25497464,24903518,"1",2934940,"Farm B","Sample",-1,"-1",21968578,"USDA4518"
"USDA4541","94279","14","Control","8/26/19",14,48468476,46275428,"2",5484905,"Farm A","Sample",0,"-1",40790523,"USDA4541"
"USDA4548","5718","2","Control","11/25/19",2,34833240,32650393,"2",2651856,"Farm C","Sample",0,"-1",29998537,"USDA4548"
"USDA4568","5802","7","Control","11/20/19",7,33251300,32461483,"2",1800311,"Farm C","Sample",0,"-1",30661172,"USDA4568"
"USDA4571","5439","9","Control","11/18/19",9,29310104,28458929,"1",2515689,"Farm C","Sample",0,"-1",25943240,"USDA4571"
"USDA4579","5844","12","Control","11/3/19",12,37517484,36609065,"2",3544271,"Farm C","Sample",0,"-1",33064794,"USDA4579"
"USDA4611","5049","12","Case","10/20/19",-10,36306834,34483062,"1",2000107,"Farm C","Sample",-22,"-4",32482955,"USDA4611"
"USDA4746","1760","7","Control","5/23/19",-1,27910188,27201617,"2",54790,"Farm D","Sample",-8,"-2",27146827,"USDA4746"
"USDA4749","94176","7","Control","10/2/19",-19,25914616,25306544,"2",4950713,"Farm A","Sample",-26,"-4",20355831,"USDA4749"
"USDA4752","84568","18","Case","9/21/19",-8,23997937,23448126,"3",934381,"Farm A","Sample",-26,"-4",22513745,"USDA4752"
"USDA5101","84956","17","Case","9/17/19",-6,27701578,27106156,"3",3314810,"Farm A","Sample",-23,"-4",23791346,"USDA5101"
"USDA5102","84741","24","Case","9/12/19",-1,28478314,27864536,"2",1443360,"Farm A","Sample",-25,"-4",26421176,"USDA5102"
"USDA5140","84901","11","Control","9/28/19",11,35458036,34529863,"2",6877360,"Farm A","Sample",0,"-1",27652503,"USDA5140"
"USDA5156","84741","24","Case","9/12/19",-30,40148269,39086776,"3",24088225,"Farm A","Sample",-54,"â‰¥ -7",14998551,"USDA5156"
"USDA5306","69116","7","Case","8/30/19",-1,24098331,23114633,"2",4245896,"Farm A","Sample",-8,"-2",18868737,"USDA5306"
"USDA5307","84741","24","Case","9/12/19",-14,25362154,24769505,"2",3295552,"Farm A","Sample",-38,"-6",21473953,"USDA5307"
"USDA5311","84568","18","Case","9/21/19",-23,24923168,24345503,"1",6158750,"Farm A","Sample",-41,"-6",18186753,"USDA5311"
"USDA5313","84753","7","Control","8/30/19",-1,24692939,23954361,"1",1727511,"Farm A","Sample",-8,"-2",22226850,"USDA5313"
"USDA5320","68688","13","Case","8/31/19",-2,35651607,34062845,"1",4540958,"Farm A","Sample",-15,"-3",29521887,"USDA5320"
"USDA5321","84738","21","Case","9/7/19",-9,26422043,25826588,"1",22527610,"Farm A","Sample",-30,"-5",3298978,"USDA5321"
"USDA5329","85135","8","Control","9/21/19",-23,24512333,23891179,"1",1371449,"Farm A","Sample",-31,"-5",22519730,"USDA5329"
"USDA5336","93745","17","Control","10/15/19",-21,29343944,28678192,"2",282546,"Farm A","Sample",-38,"-6",28395646,"USDA5336"
"USDA5337","68923","7","Control","10/5/19",-11,26208475,25139004,"2",1186607,"Farm A","Sample",-18,"-3",23952397,"USDA5337"
"USDA5341","94134","22","Control","9/6/19",22,29831874,28301438,"2",5072879,"Farm A","Sample",0,"-1",23228559,"USDA5341"
"USDA5344","84738","21","Case","9/7/19",21,33505278,32553700,"2",9867129,"Farm A","Sample",0,"-1",22686571,"USDA5344"
"USDA5350","69002","21","Control","10/11/19",-17,36742124,35299296,"2",1197905,"Farm A","Sample",-38,"-6",34101391,"USDA5350"
"USDA5354","84956","17","Case","9/17/19",7,36674448,35860781,"1",4403925,"Farm A","Sample",-10,"-2",31456856,"USDA5354"
"USDA5369","68688","13","Case","8/31/19",13,29095740,27169527,"1",13548649,"Farm A","Sample",0,"-1",13620878,"USDA5369"
"USDA5387","87215","14","Control","9/9/19",14,41383469,40297383,"1",4420883,"Farm A","Sample",0,"-1",35876500,"USDA5387"
"USDA5390","93845","5","Case","9/18/19",5,38604949,37254590,"2",27702466,"Farm A","Sample",0,"-1",9552124,"USDA5390"
"USDA5397","84738","21","Case","9/7/19",16,33410104,32700142,"1",17450155,"Farm A","Sample",-5,"-1",15249987,"USDA5397"
"USDA5402","84738","21","Case","9/7/19",12,28681374,27819113,"1",13639631,"Farm A","Sample",-9,"-2",14179482,"USDA5402"
"USDA5413","93845","5","Case","9/18/19",-7,26004627,25261203,"2",7967098,"Farm A","Sample",-12,"-2",17294105,"USDA5413"
"USDA5428","69002","21","Control","10/11/19",-22,46987780,45392168,"2",114503,"Farm A","Sample",-43,"â‰¥ -7",45277665,"USDA5428"
"USDA5436","87221","19","Control","8/26/19",19,23824954,22942810,"2",4889300,"Farm A","Sample",0,"-1",18053510,"USDA5436"
"USDA5437","84741","24","Case","9/12/19",24,31473859,30562826,"1",21881941,"Farm A","Sample",0,"-1",8680885,"USDA5437"
"USDA5441","94057","21","Case","8/24/19",21,40048118,38868465,"2",6774625,"Farm A","Sample",0,"-1",32093840,"USDA5441"
"USDA5449","68923","7","Control","10/5/19",-3,26732731,26032799,"1",776303,"Farm A","Sample",-10,"-2",25256496,"USDA5449"
"USDA5451","68726","21","Case","10/2/19",0,43131405,40799217,"1",10125894,"Farm A","Sample",-21,"-3",30673323,"USDA5451"
"USDA5452","87216","15","Case","10/3/19",-1,23628856,23052587,"2",3263314,"Farm A","Sample",-16,"-3",19789273,"USDA5452"
"USDA5469","94122","23","Control","10/14/19",-12,32914451,32213323,"2",318118,"Farm A","Sample",-35,"-5",31895205,"USDA5469"
"USDA5476","69002","21","Control","10/11/19",-9,27548802,27007121,"2",94185,"Farm A","Sample",-30,"-5",26912936,"USDA5476"
"USDA5477","93745","17","Control","10/15/19",-13,28935117,28376788,"1",489204,"Farm A","Sample",-30,"-5",27887584,"USDA5477"
"USDA5485","84521","4","Case","8/26/19",4,25807260,25197220,"1",14660475,"Farm A","Sample",0,"-1",10536745,"USDA5485"
"USDA5494","94279","14","Control","8/26/19",7,29611126,28799258,"3",17558219,"Farm A","Sample",-7,"-1",11241039,"USDA5494"
"USDA5499","94057","21","Case","8/24/19",9,32402635,31564856,"2",18210228,"Farm A","Sample",-12,"-2",13354628,"USDA5499"
"USDA5521","84446","7","Case","8/16/19",7,24979128,24261936,"2",9111200,"Farm A","Sample",0,"-1",15150736,"USDA5521"
"USDA5545","85135","8","Control","9/21/19",-10,28863756,28227246,"2",2651365,"Farm A","Sample",-18,"-3",25575881,"USDA5545"
"USDA5547","84778","7","Control","10/11/19",-30,31500606,30545715,"2",1307817,"Farm A","Sample",-37,"-6",29237898,"USDA5547"
"USDA5550","85111","6","Case","9/23/19",-12,30343383,29743400,"1",690131,"Farm A","Sample",-18,"-3",29053269,"USDA5550"
"USDA5553","94176","7","Control","10/2/19",7,28552630,27736217,"2",10536414,"Farm A","Sample",0,"-1",17199803,"USDA5553"
"USDA5562","69228","25","Case","9/28/19",-17,25659223,24946123,"2",837222,"Farm A","Sample",-42,"-6",24108901,"USDA5562"
"USDA5579","69228","25","Case","9/28/19",-32,29209101,28619453,"1",2469948,"Farm A","Sample",-57,"â‰¥ -7",26149505,"USDA5579"
"USDA5585","87215","14","Control","9/9/19",-13,36515304,35276594,"1",3209902,"Farm A","Sample",-27,"-4",32066692,"USDA5585"
"USDA5588","94134","22","Control","9/6/19",-10,24033848,23499775,"2",1912583,"Farm A","Sample",-32,"-5",21587192,"USDA5588"
"USDA5599","84901","11","Control","9/28/19",7,38803582,37798733,"2",10186853,"Farm A","Sample",-4,"-1",27611880,"USDA5599"
"USDA5606","69228","25","Case","9/28/19",7,35921175,34730612,"3",18879255,"Farm A","Sample",-18,"-3",15851357,"USDA5606"
"USDA5612","84924","7","Case","9/28/19",7,35868927,34964505,"2",11343003,"Farm A","Sample",0,"-1",23621502,"USDA5612"
"USDA5631","94134","22","Control","9/6/19",14,29507889,28460052,"1",6336187,"Farm A","Sample",-8,"-2",22123865,"USDA5631"
"USDA5659","84956","17","Case","9/17/19",17,30907336,30190679,"3",6248883,"Farm A","Sample",0,"-1",23941796,"USDA5659"
"USDA5686","84568","18","Case","9/21/19",18,34676338,33958515,"1",9965259,"Farm A","Sample",0,"-1",23993256,"USDA5686"
"USDA5687","93745","17","Control","10/15/19",-6,30646635,29679581,"1",269702,"Farm A","Sample",-23,"-4",29409879,"USDA5687"
